YEAR,COUNTY_CODE,COUNTY_NAME,SECTOR_CODE,SECTOR,SCHOOL_TYPE_CODE,SCHOOL_TYPE,SCHOOL_LEVEL_CODE,SCHOOL_LEVEL,SEDCODE,INST_ID,LEGAL_NAME,UNDERGRADUATE_FULLTIME_TOTAL,UNDERGRADUATE_FT_ENR_PROGRAM,UNDERGRADUATE_FT_NOT_ENR_PROGRAM,UNDERGRADUATE_PARTTIME,UNDERGRADUATE_PT_ENR_PROGRAM,UNDERGRADUATE_PT_NOT_ENR_PROGRAM,FIRST_PROFESSIONAL_FULLTIME,FIRST_PROFESSIONAL_PARTTIME,GRADUATE_FULLTIME,GRADUATE_PARTTIME,ALL_STUDENTS_FULLTIME,ALL_STUDENTS_PARTTIME,FIRST_TIME_FULLTIME,FIRST_TIME_PARTTIME,TOTAL,FTE
2012,01,ALBANY,4,PUBLIC - SPECIAL,0,PUBLIC,1,4-Year/Grad,110000,800000070361,NYSDOH WADSWORTH CENTER FOR LABORATORIES & RSRC,0,0,0,0,0,0,0,0,4,0,4,0,0,0,4,4
2013,01,ALBANY,4,PUBLIC - SPECIAL,0,PUBLIC,1,4-Year/Grad,110000,800000070361,NYSDOH WADSWORTH CENTER FOR LABORATORIES & RSRC,0,0,0,0,0,0,0,0,5,0,5,0,0,0,5,5
2014,01,ALBANY,4,PUBLIC - SPECIAL,0,PUBLIC,1,4-Year/Grad,110000,800000070361,NYSDOH WADSWORTH CENTER FOR LABORATORIES & RSRC,0,0,0,0,0,0,0,0,8,0,8,0,0,0,8,8
2015,01,ALBANY,4,PUBLIC - SPECIAL,0,PUBLIC,1,4-Year/Grad,110000,800000070361,NYSDOH WADSWORTH CENTER FOR LABORATORIES & RSRC,0,0,0,0,0,0,0,0,5,0,5,0,0,0,5,5
2016,01,ALBANY,4,PUBLIC - SPECIAL,0,PUBLIC,1,4-Year/Grad,110000,800000070361,NYSDOH WADSWORTH CENTER FOR LABORATORIES & RSRC,0,0,0,0,0,0,0,0,6,0,6,0,0,0,6,6
2017,01,ALBANY,4,PUBLIC - SPECIAL,0,PUBLIC,1,4-Year/Grad,110000,800000070361,NYSDOH WADSWORTH CENTER FOR LABORATORIES & RSRC,0,0,0,0,0,0,0,0,5,0,5,0,0,0,5,5
2010,01,ALBANY,0,SUNY,0,PUBLIC,1,4-Year/Grad,210500,800000055597,STATE UNIVERSITY OF NEW YORK AT ALBANY,12139,12038,101,820,585,235,0,0,2279,2377,14418,3197,2248,70,17615,15642.13
2011,01,ALBANY,0,SUNY,0,PUBLIC,1,4-Year/Grad,210500,800000055597,STATE UNIVERSITY OF NEW YORK AT ALBANY,11925,11827,98,830,603,227,0,0,2117,2242,14042,3072,2429,55,17114,15215.47
2012,01,ALBANY,0,SUNY,0,PUBLIC,1,4-Year/Grad,210500,800000055597,STATE UNIVERSITY OF NEW YORK AT ALBANY,12064,12001,63,814,634,180,0,0,2179,2255,14243,3069,2567,33,17312,15416.33
2013,01,ALBANY,0,SUNY,0,PUBLIC,1,4-Year/Grad,210500,800000055597,STATE UNIVERSITY OF NEW YORK AT ALBANY,12055,11968,87,767,574,193,0,0,2343,2173,14398,2940,2571,35,17338,15522.87
2014,01,ALBANY,0,SUNY,0,PUBLIC,1,4-Year/Grad,210500,800000055597,STATE UNIVERSITY OF NEW YORK AT ALBANY,12191,12095,96,738,564,174,0,0,2218,2126,14409,2864,2555,44,17273,15505.4
2015,01,ALBANY,0,SUNY,0,PUBLIC,1,4-Year/Grad,210500,800000055597,STATE UNIVERSITY OF NEW YORK AT ALBANY,12223,12151,72,8520,547,7973,0,0,2218,2053,14441,10573,2594,28,25014,18102.2
2016,01,ALBANY,0,SUNY,0,PUBLIC,1,4-Year/Grad,210500,800000055597,STATE UNIVERSITY OF NEW YORK AT ALBANY,12421,12387,34,8307,568,7739,0,0,2099,2135,14520,10442,2724,35,24962,18143
2017,01,ALBANY,0,SUNY,0,PUBLIC,1,4-Year/Grad,210500,800000055597,STATE UNIVERSITY OF NEW YORK AT ALBANY,12740,12703,37,8333,617,7716,0,0,2109,2126,14849,10459,2816,28,25308,18477.07
2018,01,ALBANY,0,SUNY,0,PUBLIC,1,4-Year/Grad,210500,800000055597,STATE UNIVERSITY OF NEW YORK AT ALBANY,12899,12871,28,8928,563,8365,0,0,2157,2189,15056,11117,2768,20,26173,18907.6
2019,01,ALBANY,0,SUNY,0,PUBLIC,1,4-Year/Grad,210500,800000055597,STATE UNIVERSITY OF NEW YORK AT ALBANY,12568,12548,20,718,605,113,0,0,2108,2150,14676,2868,2670,19,17544,15775.33
2010,03,BROOME,0,SUNY,0,PUBLIC,1,4-Year/Grad,211000,800000055037,STATE UNIVERSITY OF NEW YORK AT BINGHAMTON,11381,11365,16,406,380,26,0,0,1688,1420,13069,1826,2229,93,14895,13772.33
2011,03,BROOME,0,SUNY,0,PUBLIC,1,4-Year/Grad,211000,800000055037,STATE UNIVERSITY OF NEW YORK AT BINGHAMTON,11464,11458,6,397,370,27,0,0,1566,1319,13030,1716,2435,83,14746,13689.93
2012,03,BROOME,0,SUNY,0,PUBLIC,1,4-Year/Grad,211000,800000055037,STATE UNIVERSITY OF NEW YORK AT BINGHAMTON,11904,11877,27,452,419,33,3,8,1679,1262,13586,1722,2589,95,15308,14244.67
2013,03,BROOME,0,SUNY,0,PUBLIC,1,4-Year/Grad,211000,800000055037,STATE UNIVERSITY OF NEW YORK AT BINGHAMTON,12559,12548,11,438,392,46,4,14,1820,1242,14383,1694,2585,49,16077,15031.4
2014,03,BROOME,0,SUNY,0,PUBLIC,1,4-Year/Grad,211000,800000055037,STATE UNIVERSITY OF NEW YORK AT BINGHAMTON,12908,12906,2,504,466,38,4,11,1940,1328,14852,1843,2528,82,16695,15555.6
2015,03,BROOME,0,SUNY,0,PUBLIC,1,4-Year/Grad,211000,800000055037,STATE UNIVERSITY OF NEW YORK AT BINGHAMTON,13054,13045,9,437,420,17,5,10,2054,1353,15113,1800,2594,69,16913,15803.87
2016,03,BROOME,0,SUNY,0,PUBLIC,1,4-Year/Grad,211000,800000055037,STATE UNIVERSITY OF NEW YORK AT BINGHAMTON,13185,13179,6,447,399,48,12,0,2141,1507,15338,1954,2642,70,17292,16089.8
2017,03,BROOME,0,SUNY,0,PUBLIC,1,4-Year/Grad,211000,800000055037,STATE UNIVERSITY OF NEW YORK AT BINGHAMTON,13337,13334,3,371,359,12,4,7,2093,1510,15434,1888,2673,65,17322,16164.47
2018,03,BROOME,0,SUNY,0,PUBLIC,1,4-Year/Grad,211000,800000055037,STATE UNIVERSITY OF NEW YORK AT BINGHAMTON,13630,13627,3,391,363,28,154,0,1971,1622,15755,2013,2907,43,17768,16534.13
2019,03,BROOME,0,SUNY,0,PUBLIC,1,4-Year/Grad,211000,800000055037,STATE UNIVERSITY OF NEW YORK AT BINGHAMTON,13845,13844,1,323,315,8,238,0,2082,1641,16165,1964,2893,21,18129,16929.07
2010,14,ERIE,0,SUNY,0,PUBLIC,1,4-Year/Grad,211500,800000052554,STATE UNIVERSITY OF NEW YORK AT BUFFALO,18013,17952,61,1433,1261,172,1973,5,4273,3420,24259,4858,3357,39,29117,26106.67
2011,14,ERIE,0,SUNY,0,PUBLIC,1,4-Year/Grad,211500,800000052554,STATE UNIVERSITY OF NEW YORK AT BUFFALO,17664,17507,157,1670,1487,183,1942,6,4095,3472,23701,5148,3234,32,28849,25648.87
2012,14,ERIE,0,SUNY,0,PUBLIC,1,4-Year/Grad,211500,800000052554,STATE UNIVERSITY OF NEW YORK AT BUFFALO,17766,17598,168,1893,1531,362,2303,40,3967,3160,24036,5093,3617,39,29129,25947
2013,14,ERIE,0,SUNY,0,PUBLIC,1,4-Year/Grad,211500,800000052554,STATE UNIVERSITY OF NEW YORK AT BUFFALO,18091,17793,298,1740,1572,168,2293,60,4432,3234,24816,5034,3652,19,29850,26713.6
2014,14,ERIE,0,SUNY,0,PUBLIC,1,4-Year/Grad,211500,800000052554,STATE UNIVERSITY OF NEW YORK AT BUFFALO,18166,17991,175,1716,1497,219,2285,86,4137,3605,24588,5407,3506,20,29995,26636.4
2015,14,ERIE,0,SUNY,0,PUBLIC,1,4-Year/Grad,211500,800000052554,STATE UNIVERSITY OF NEW YORK AT BUFFALO,18452,18336,116,1501,1358,143,2224,96,4178,3357,24854,4954,3688,14,29808,26735.53
2016,14,ERIE,0,SUNY,0,PUBLIC,1,4-Year/Grad,211500,800000052554,STATE UNIVERSITY OF NEW YORK AT BUFFALO,18824,18732,92,1588,1370,218,2303,4,4051,3414,25178,5006,4137,21,30184,27074.53
2017,14,ERIE,0,SUNY,0,PUBLIC,1,4-Year/Grad,211500,800000052554,STATE UNIVERSITY OF NEW YORK AT BUFFALO,19401,19316,85,1619,1419,200,2360,2,4395,3322,26156,4943,4231,11,31099,28025.27
2018,14,ERIE,0,SUNY,0,PUBLIC,1,4-Year/Grad,211500,800000052554,STATE UNIVERSITY OF NEW YORK AT BUFFALO,19941,19913,28,1671,1491,180,2391,5,4142,3358,26474,5034,4259,13,31508,28376.2
2019,14,ERIE,0,SUNY,0,PUBLIC,1,4-Year/Grad,211500,800000052554,STATE UNIVERSITY OF NEW YORK AT BUFFALO,20401,20374,27,1524,1386,138,2397,0,3964,3641,26762,5165,4282,17,31927,28726.4
2010,58,SUFFOLK,0,SUNY,0,PUBLIC,1,4-Year/Grad,212000,800000037713,STATE UNIVERSITY OF NEW YORK AT STONY BROOK,14853,14853,0,1284,1202,82,661,0,4334,3242,19848,4526,2733,8,24374,21572.8
2011,58,SUFFOLK,0,SUNY,0,PUBLIC,1,4-Year/Grad,212000,800000037713,STATE UNIVERSITY OF NEW YORK AT STONY BROOK,14485,14466,19,1300,1189,111,668,0,4469,2998,19622,4298,2516,4,23920,21254.53
2012,58,SUFFOLK,0,SUNY,0,PUBLIC,1,4-Year/Grad,212000,800000037713,STATE UNIVERSITY OF NEW YORK AT STONY BROOK,14445,14437,8,1271,1181,90,852,60,4416,2817,19713,4148,2680,17,23861,21287.47
2013,58,SUFFOLK,0,SUNY,0,PUBLIC,1,4-Year/Grad,212000,800000037713,STATE UNIVERSITY OF NEW YORK AT STONY BROOK,14754,14751,3,1099,1034,65,873,89,4279,2906,19906,4094,2708,1,24000,21470.33
2014,58,SUFFOLK,0,SUNY,0,PUBLIC,1,4-Year/Grad,212000,800000037713,STATE UNIVERSITY OF NEW YORK AT STONY BROOK,15189,15188,1,1095,1028,67,891,76,4370,2831,20450,4002,2852,3,24452,21977.8
2015,58,SUFFOLK,0,SUNY,0,PUBLIC,1,4-Year/Grad,212000,800000037713,STATE UNIVERSITY OF NEW YORK AT STONY BROOK,15575,15572,3,1108,1051,57,964,37,4408,3068,20947,4213,2836,0,25160,22558.33
2016,58,SUFFOLK,0,SUNY,0,PUBLIC,1,4-Year/Grad,212000,800000037713,STATE UNIVERSITY OF NEW YORK AT STONY BROOK,15858,15729,129,1168,1134,34,975,23,4444,3266,21277,4457,2931,3,25734,22981.93
2017,58,SUFFOLK,0,SUNY,0,PUBLIC,1,4-Year/Grad,212000,800000037713,STATE UNIVERSITY OF NEW YORK AT STONY BROOK,16142,16141,1,1151,1120,31,1005,0,4616,3042,21763,4193,3160,7,25956,23363.47
2018,58,SUFFOLK,0,SUNY,0,PUBLIC,1,4-Year/Grad,212000,800000037713,STATE UNIVERSITY OF NEW YORK AT STONY BROOK,16341,16243,98,1181,1164,17,992,18,4373,3351,21706,4550,3375,8,26256,23447.27
2019,58,SUFFOLK,0,SUNY,0,PUBLIC,1,4-Year/Grad,212000,800000037713,STATE UNIVERSITY OF NEW YORK AT STONY BROOK,16697,16579,118,1212,1188,24,1001,18,4490,3396,22188,4626,3369,3,26814,23957.6
2010,33,KINGS,0,SUNY,0,PUBLIC,1,4-Year/Grad,221000,800000044751,STATE UNIVERSITY OF NEW YORK HEALTH SCIENCE CENTER AT BROOKLYN,193,193,0,156,149,7,793,0,223,337,1209,493,0,0,1702,1395.8
2011,33,KINGS,0,SUNY,0,PUBLIC,1,4-Year/Grad,221000,800000044751,STATE UNIVERSITY OF NEW YORK HEALTH SCIENCE CENTER AT BROOKLYN,184,184,0,165,152,13,807,0,230,365,1221,530,0,0,1751,1422
2012,33,KINGS,0,SUNY,0,PUBLIC,1,4-Year/Grad,221000,800000044751,STATE UNIVERSITY OF NEW YORK HEALTH SCIENCE CENTER AT BROOKLYN,213,213,0,139,122,17,866,2,205,374,1284,515,0,0,1799,1480.73
2014,33,KINGS,0,SUNY,0,PUBLIC,1,4-Year/Grad,221000,800000044751,STATE UNIVERSITY OF NEW YORK HEALTH SCIENCE CENTER AT BROOKLYN,216,216,0,128,122,6,849,3,300,369,1365,500,0,0,1865,1556.47
2015,33,KINGS,0,SUNY,0,PUBLIC,1,4-Year/Grad,221000,800000044751,STATE UNIVERSITY OF NEW YORK HEALTH SCIENCE CENTER AT BROOKLYN,160,160,0,187,186,1,841,10,299,368,1300,565,0,1,1865,1513.53
2016,33,KINGS,0,SUNY,0,PUBLIC,1,4-Year/Grad,221000,800000044751,STATE UNIVERSITY OF NEW YORK HEALTH SCIENCE CENTER AT BROOKLYN,262,262,0,76,76,0,835,0,351,315,1448,391,0,0,1839,1599.33
2017,33,KINGS,0,SUNY,0,PUBLIC,1,4-Year/Grad,221000,800000044751,STATE UNIVERSITY OF NEW YORK HEALTH SCIENCE CENTER AT BROOKLYN,213,213,0,14,12,2,859,0,397,309,1469,323,0,0,1792,1597.27
2018,33,KINGS,0,SUNY,0,PUBLIC,1,4-Year/Grad,221000,800000044751,STATE UNIVERSITY OF NEW YORK HEALTH SCIENCE CENTER AT BROOKLYN,193,193,0,18,18,0,870,0,465,300,1528,318,0,0,1846,1654
2019,33,KINGS,0,SUNY,0,PUBLIC,1,4-Year/Grad,221000,800000044751,STATE UNIVERSITY OF NEW YORK HEALTH SCIENCE CENTER AT BROOKLYN,178,178,0,4,4,0,857,0,548,312,1583,316,0,0,1899,1709.13
2010,42,ONONDAGA,0,SUNY,0,PUBLIC,1,4-Year/Grad,222000,800000040737,STATE UNIVERSITY OF NEW YORK HEALTH SCIENCE CENTER AT SYRACUSE,211,211,0,88,80,8,634,0,352,252,1197,340,0,0,1537,1327.13
2011,42,ONONDAGA,0,SUNY,0,PUBLIC,1,4-Year/Grad,222000,800000040737,STATE UNIVERSITY OF NEW YORK HEALTH SCIENCE CENTER AT SYRACUSE,213,213,0,83,75,8,635,0,405,253,1253,336,0,0,1589,1381.87
2012,42,ONONDAGA,0,SUNY,0,PUBLIC,1,4-Year/Grad,222000,800000040737,STATE UNIVERSITY OF NEW YORK HEALTH SCIENCE CENTER AT SYRACUSE,211,211,0,91,84,7,730,44,328,231,1269,366,0,0,1635,1409.33
2014,42,ONONDAGA,0,SUNY,0,PUBLIC,1,4-Year/Grad,222000,800000040737,STATE UNIVERSITY OF NEW YORK HEALTH SCIENCE CENTER AT SYRACUSE,174,174,0,61,58,3,741,46,325,169,1240,276,0,0,1516,1346.33
2015,42,ONONDAGA,0,SUNY,0,PUBLIC,1,4-Year/Grad,222000,800000040737,STATE UNIVERSITY OF NEW YORK HEALTH SCIENCE CENTER AT SYRACUSE,160,160,0,59,57,2,729,37,352,143,1241,239,0,0,1480,1332.67
2016,42,ONONDAGA,0,SUNY,0,PUBLIC,1,4-Year/Grad,222000,800000040737,STATE UNIVERSITY OF NEW YORK HEALTH SCIENCE CENTER AT SYRACUSE,154,154,0,57,53,4,777,0,384,119,1315,176,0,0,1491,1381.6
2017,42,ONONDAGA,0,SUNY,0,PUBLIC,1,4-Year/Grad,222000,800000040737,STATE UNIVERSITY OF NEW YORK HEALTH SCIENCE CENTER AT SYRACUSE,163,163,0,87,83,4,734,0,368,132,1265,219,0,0,1484,1346.8
2018,42,ONONDAGA,0,SUNY,0,PUBLIC,1,4-Year/Grad,222000,800000040737,STATE UNIVERSITY OF NEW YORK HEALTH SCIENCE CENTER AT SYRACUSE,165,165,0,84,83,1,786,15,389,153,1340,252,0,0,1592,1435.2
2019,42,ONONDAGA,0,SUNY,0,PUBLIC,1,4-Year/Grad,222000,800000040737,STATE UNIVERSITY OF NEW YORK HEALTH SCIENCE CENTER AT SYRACUSE,153,153,0,85,82,3,802,0,417,131,1372,216,0,0,1588,1452.73
2010,26,MONROE,0,SUNY,0,PUBLIC,1,4-Year/Grad,230500,800000050056,STATE UNIVERSITY OF NEW YORK COLLEGE AT BROCKPORT,6645,6643,2,652,634,18,0,0,395,897,7040,1549,1048,0,8589,7616.13
2011,26,MONROE,0,SUNY,0,PUBLIC,1,4-Year/Grad,230500,800000050056,STATE UNIVERSITY OF NEW YORK COLLEGE AT BROCKPORT,6454,6451,3,712,690,22,0,0,365,882,6819,1594,1050,0,8413,7409.13
2012,26,MONROE,0,SUNY,0,PUBLIC,1,4-Year/Grad,230500,800000050056,STATE UNIVERSITY OF NEW YORK COLLEGE AT BROCKPORT,6444,6444,0,689,601,88,0,0,367,771,6811,1460,1083,2,8271,7349.07
2013,26,MONROE,0,SUNY,0,PUBLIC,1,4-Year/Grad,230500,800000050056,STATE UNIVERSITY OF NEW YORK COLLEGE AT BROCKPORT,6411,6410,1,679,630,49,0,0,318,720,6729,1399,1080,25,8128,7243.33
2014,26,MONROE,0,SUNY,0,PUBLIC,1,4-Year/Grad,230500,800000050056,STATE UNIVERSITY OF NEW YORK COLLEGE AT BROCKPORT,6304,6304,0,736,647,89,0,0,358,708,6662,1444,1089,1,8106,7190.53
2015,26,MONROE,0,SUNY,0,PUBLIC,1,4-Year/Grad,230500,800000050056,STATE UNIVERSITY OF NEW YORK COLLEGE AT BROCKPORT,6353,6352,1,716,645,71,0,0,373,719,6726,1435,1144,7,8161,7252.27
2016,26,MONROE,0,SUNY,0,PUBLIC,1,4-Year/Grad,230500,800000050056,STATE UNIVERSITY OF NEW YORK COLLEGE AT BROCKPORT,6375,6375,0,753,691,62,0,0,345,770,6720,1523,1202,7,8243,7279
2017,26,MONROE,0,SUNY,0,PUBLIC,1,4-Year/Grad,230500,800000050056,STATE UNIVERSITY OF NEW YORK COLLEGE AT BROCKPORT,6419,6418,1,761,716,45,0,0,353,780,6772,1541,1258,13,8313,7337.67
2018,26,MONROE,0,SUNY,0,PUBLIC,1,4-Year/Grad,230500,800000050056,STATE UNIVERSITY OF NEW YORK COLLEGE AT BROCKPORT,6343,6343,0,714,672,42,0,0,353,877,6696,1591,1270,11,8287,7284.8
2019,26,MONROE,0,SUNY,0,PUBLIC,1,4-Year/Grad,230500,800000050056,STATE UNIVERSITY OF NEW YORK COLLEGE AT BROCKPORT,5960,5960,0,713,664,49,0,0,349,902,6309,1615,1077,9,7924,6907.47
2010,14,ERIE,0,SUNY,0,PUBLIC,1,4-Year/Grad,231000,800000052555,STATE UNIVERSITY OF NEW YORK COLLEGE AT BUFFALO,8853,8840,13,1072,883,189,0,0,582,1912,9435,2984,1461,34,12419,10557.13
2011,14,ERIE,0,SUNY,0,PUBLIC,1,4-Year/Grad,231000,800000052555,STATE UNIVERSITY OF NEW YORK COLLEGE AT BUFFALO,8811,8797,14,1201,1009,192,0,0,511,1681,9322,2882,1392,35,12204,10394.73
2012,14,ERIE,0,SUNY,0,PUBLIC,1,4-Year/Grad,231000,800000052555,STATE UNIVERSITY OF NEW YORK COLLEGE AT BUFFALO,8606,8583,23,1141,978,163,0,0,516,1518,9122,2659,1347,24,11781,10109.53
2013,14,ERIE,0,SUNY,0,PUBLIC,1,4-Year/Grad,231000,800000052555,STATE UNIVERSITY OF NEW YORK COLLEGE AT BUFFALO,8293,8272,21,1062,918,144,0,0,506,1230,8799,2292,1336,28,11091,9645
2014,14,ERIE,0,SUNY,0,PUBLIC,1,4-Year/Grad,231000,800000052555,STATE UNIVERSITY OF NEW YORK COLLEGE AT BUFFALO,8326,8278,48,1149,907,242,0,0,514,1094,8840,2243,1877,37,11083,9660.6
2015,14,ERIE,0,SUNY,0,PUBLIC,1,4-Year/Grad,231000,800000052555,STATE UNIVERSITY OF NEW YORK COLLEGE AT BUFFALO,8137,8111,26,1050,907,143,0,0,442,701,8579,1751,1851,41,10330,9209.4
2016,14,ERIE,0,SUNY,0,PUBLIC,1,4-Year/Grad,231000,800000052555,STATE UNIVERSITY OF NEW YORK COLLEGE AT BUFFALO,7598,7590,8,884,770,114,0,0,416,577,8014,1461,1627,11,9475,8539.47
2017,14,ERIE,0,SUNY,0,PUBLIC,1,4-Year/Grad,231000,800000052555,STATE UNIVERSITY OF NEW YORK COLLEGE AT BUFFALO,7681,7639,42,1001,756,245,0,0,378,611,8059,1612,1823,11,9671,8637.07
2018,14,ERIE,0,SUNY,0,PUBLIC,1,4-Year/Grad,231000,800000052555,STATE UNIVERSITY OF NEW YORK COLLEGE AT BUFFALO,7291,7255,36,884,689,195,0,0,416,620,7707,1504,1759,18,9211,8249.67
2019,14,ERIE,0,SUNY,0,PUBLIC,1,4-Year/Grad,231000,800000052555,STATE UNIVERSITY OF NEW YORK COLLEGE AT BUFFALO,6928,6883,45,783,618,165,0,0,421,590,7349,1373,1671,17,8722,7846
2010,11,CORTLAND,0,SUNY,0,PUBLIC,1,4-Year/Grad,231500,800000053640,STATE UNIVERSITY OF NEW YORK COLLEGE AT CORTLAND,6106,6088,18,204,99,105,0,0,391,657,6497,861,1218,3,7358,6827.8
2011,11,CORTLAND,0,SUNY,0,PUBLIC,1,4-Year/Grad,231500,800000053640,STATE UNIVERSITY OF NEW YORK COLLEGE AT CORTLAND,6241,6232,9,130,112,18,0,0,370,590,6611,720,1201,4,7331,6890.33
2012,11,CORTLAND,0,SUNY,0,PUBLIC,1,4-Year/Grad,231500,800000053640,STATE UNIVERSITY OF NEW YORK COLLEGE AT CORTLAND,6228,6224,4,117,104,13,0,0,250,503,6478,620,1210,3,7098,6718.2
2013,11,CORTLAND,0,SUNY,0,PUBLIC,1,4-Year/Grad,231500,800000053640,STATE UNIVERSITY OF NEW YORK COLLEGE AT CORTLAND,6281,6281,0,119,113,6,0,0,256,454,6537,573,1207,1,7110,6758.27
2014,11,CORTLAND,0,SUNY,0,PUBLIC,1,4-Year/Grad,231500,800000053640,STATE UNIVERSITY OF NEW YORK COLLEGE AT CORTLAND,6203,6203,0,114,108,6,0,0,227,414,6430,528,1196,6,6958,6633.6
2015,11,CORTLAND,0,SUNY,0,PUBLIC,1,4-Year/Grad,231500,800000053640,STATE UNIVERSITY OF NEW YORK COLLEGE AT CORTLAND,6179,6179,0,104,97,7,0,0,242,401,6421,505,1214,0,6926,6616.07
2016,11,CORTLAND,0,SUNY,0,PUBLIC,1,4-Year/Grad,231500,800000053640,STATE UNIVERSITY OF NEW YORK COLLEGE AT CORTLAND,6187,6187,0,117,105,12,0,0,208,388,6395,505,1238,2,6900,6589.2
2017,11,CORTLAND,0,SUNY,0,PUBLIC,1,4-Year/Grad,231500,800000053640,STATE UNIVERSITY OF NEW YORK COLLEGE AT CORTLAND,6196,6195,1,150,138,12,0,0,197,370,6393,520,1288,1,6913,6591
2018,11,CORTLAND,0,SUNY,0,PUBLIC,1,4-Year/Grad,231500,800000053640,STATE UNIVERSITY OF NEW YORK COLLEGE AT CORTLAND,6218,6218,0,125,107,18,0,0,173,342,6391,467,1220,1,6858,6569.47
2019,11,CORTLAND,0,SUNY,0,PUBLIC,1,4-Year/Grad,231500,800000053640,STATE UNIVERSITY OF NEW YORK COLLEGE AT CORTLAND,6170,6170,0,125,111,14,0,0,209,330,6379,455,1207,3,6834,6552.67
2010,52,SARATOGA,0,SUNY,0,PUBLIC,1,4-Year/Grad,232000,800000038529,STATE UNIVERSITY OF NEW YORK EMPIRE STATE COLLEGE,4180,4089,91,6965,5981,984,0,0,73,767,4253,7732,143,98,11985,6881.47
2011,52,SARATOGA,0,SUNY,0,PUBLIC,1,4-Year/Grad,232000,800000038529,STATE UNIVERSITY OF NEW YORK EMPIRE STATE COLLEGE,4346,4255,91,6644,5708,936,0,0,86,751,4432,7395,144,237,11827,6947.07
2012,52,SARATOGA,0,SUNY,0,PUBLIC,1,4-Year/Grad,232000,800000038529,STATE UNIVERSITY OF NEW YORK EMPIRE STATE COLLEGE,4341,4266,75,6777,5769,1008,0,0,87,823,4428,7600,158,275,12028,7016.2
2013,52,SARATOGA,0,SUNY,0,PUBLIC,1,4-Year/Grad,232000,800000038529,STATE UNIVERSITY OF NEW YORK EMPIRE STATE COLLEGE,4218,4133,85,6609,5660,949,0,0,91,905,4309,7514,188,185,11823,6874
2014,52,SARATOGA,0,SUNY,0,PUBLIC,1,4-Year/Grad,232000,800000038529,STATE UNIVERSITY OF NEW YORK EMPIRE STATE COLLEGE,4249,4188,61,6624,5761,863,0,0,73,1006,4322,7630,185,164,11952,6932.4
2015,52,SARATOGA,0,SUNY,0,PUBLIC,1,4-Year/Grad,232000,800000038529,STATE UNIVERSITY OF NEW YORK EMPIRE STATE COLLEGE,4278,4201,77,6529,5624,905,0,0,81,990,4359,7519,156,204,11878,6931.33
2016,52,SARATOGA,0,SUNY,0,PUBLIC,1,4-Year/Grad,232000,800000038529,STATE UNIVERSITY OF NEW YORK EMPIRE STATE COLLEGE,3841,3729,112,6348,5332,1016,0,0,80,1046,3921,7394,165,186,11315,6455.4
2017,52,SARATOGA,0,SUNY,0,PUBLIC,1,4-Year/Grad,232000,800000038529,STATE UNIVERSITY OF NEW YORK EMPIRE STATE COLLEGE,3773,3673,100,6038,4950,1088,0,0,89,1078,3862,7116,191,251,10978,6305.87
2018,52,SARATOGA,0,SUNY,0,PUBLIC,1,4-Year/Grad,232000,800000038529,STATE UNIVERSITY OF NEW YORK EMPIRE STATE COLLEGE,3599,3523,76,5708,4875,833,0,0,89,1028,3688,6736,127,214,10424,6001.87
2019,52,SARATOGA,0,SUNY,0,PUBLIC,1,4-Year/Grad,232000,800000038529,STATE UNIVERSITY OF NEW YORK EMPIRE STATE COLLEGE,3267,3186,81,5828,4912,916,0,0,120,1225,3387,7053,109,249,10440,5819.67
2010,06,CHAUTAUQUA,0,SUNY,0,PUBLIC,1,4-Year/Grad,232500,800000054188,STATE UNIVERSITY OF NEW YORK COLLEGE AT FREDONIA,5233,5228,5,154,104,50,0,0,201,185,5434,339,1075,4,5773,5559.33
2011,06,CHAUTAUQUA,0,SUNY,0,PUBLIC,1,4-Year/Grad,232500,800000054188,STATE UNIVERSITY OF NEW YORK COLLEGE AT FREDONIA,5237,5235,2,150,96,54,0,0,182,151,5419,301,1123,1,5720,5529.4
2012,06,CHAUTAUQUA,0,SUNY,0,PUBLIC,1,4-Year/Grad,232500,800000054188,STATE UNIVERSITY OF NEW YORK COLLEGE AT FREDONIA,5074,5069,5,157,102,55,0,0,175,115,5249,272,1003,1,5521,5347.33
2013,06,CHAUTAUQUA,0,SUNY,0,PUBLIC,1,4-Year/Grad,232500,800000054188,STATE UNIVERSITY OF NEW YORK COLLEGE AT FREDONIA,4945,4940,5,147,109,38,0,0,204,95,5149,242,1098,11,5391,5236
2014,06,CHAUTAUQUA,0,SUNY,0,PUBLIC,1,4-Year/Grad,232500,800000054188,STATE UNIVERSITY OF NEW YORK COLLEGE AT FREDONIA,4806,4795,11,130,105,25,0,0,189,90,4995,220,1060,11,5215,5074.33
2015,06,CHAUTAUQUA,0,SUNY,0,PUBLIC,1,4-Year/Grad,232500,800000054188,STATE UNIVERSITY OF NEW YORK COLLEGE AT FREDONIA,4458,4442,16,124,100,24,0,0,153,107,4611,231,918,4,4842,4695.13
2016,06,CHAUTAUQUA,0,SUNY,0,PUBLIC,1,4-Year/Grad,232500,800000054188,STATE UNIVERSITY OF NEW YORK COLLEGE AT FREDONIA,4256,4253,3,124,99,25,0,0,143,80,4399,204,933,7,4603,4472.33
2017,06,CHAUTAUQUA,0,SUNY,0,PUBLIC,1,4-Year/Grad,232500,800000054188,STATE UNIVERSITY OF NEW YORK COLLEGE AT FREDONIA,4281,4279,2,112,87,25,0,0,153,84,4434,196,1124,10,4630,4504.93
2018,06,CHAUTAUQUA,0,SUNY,0,PUBLIC,1,4-Year/Grad,232500,800000054188,STATE UNIVERSITY OF NEW YORK COLLEGE AT FREDONIA,4314,4307,7,117,95,22,0,0,151,73,4465,190,1181,7,4655,4533.2
2019,06,CHAUTAUQUA,0,SUNY,0,PUBLIC,1,4-Year/Grad,232500,800000054188,STATE UNIVERSITY OF NEW YORK COLLEGE AT FREDONIA,4132,4127,5,89,67,22,0,0,141,84,4273,173,1001,7,4446,4336.27
2010,24,LIVINGSTON,0,SUNY,0,PUBLIC,1,4-Year/Grad,233000,800000051026,STATE UNIVERSITY OF NEW YORK COLLEGE AT GENESEO,5352,5080,272,118,94,24,0,0,95,100,5447,218,1006,2,5665,5526.33
2011,24,LIVINGSTON,0,SUNY,0,PUBLIC,1,4-Year/Grad,233000,800000051026,STATE UNIVERSITY OF NEW YORK COLLEGE AT GENESEO,5352,5056,296,124,107,17,0,0,93,95,5445,219,1008,2,5664,5524.33
2012,24,LIVINGSTON,0,SUNY,0,PUBLIC,1,4-Year/Grad,233000,800000051026,STATE UNIVERSITY OF NEW YORK COLLEGE AT GENESEO,5260,5011,249,116,98,18,0,0,70,93,5330,209,995,2,5539,5405.87
2013,24,LIVINGSTON,0,SUNY,0,PUBLIC,1,4-Year/Grad,233000,800000051026,STATE UNIVERSITY OF NEW YORK COLLEGE AT GENESEO,5386,5350,36,118,113,5,0,0,66,74,5452,192,1128,4,5644,5520.93
2014,24,LIVINGSTON,0,SUNY,0,PUBLIC,1,4-Year/Grad,233000,800000051026,STATE UNIVERSITY OF NEW YORK COLLEGE AT GENESEO,5455,5414,41,98,83,15,0,0,46,59,5501,157,1231,5,5658,5557.27
2015,24,LIVINGSTON,0,SUNY,0,PUBLIC,1,4-Year/Grad,233000,800000051026,STATE UNIVERSITY OF NEW YORK COLLEGE AT GENESEO,5470,5441,29,113,107,6,0,0,50,66,5520,179,1324,6,5699,5584.07
2016,24,LIVINGSTON,0,SUNY,0,PUBLIC,1,4-Year/Grad,233000,800000051026,STATE UNIVERSITY OF NEW YORK COLLEGE AT GENESEO,5369,5369,0,115,111,4,0,0,33,57,5402,172,1233,6,5574,5463.13
2017,24,LIVINGSTON,0,SUNY,0,PUBLIC,1,4-Year/Grad,233000,800000051026,STATE UNIVERSITY OF NEW YORK COLLEGE AT GENESEO,5420,5420,0,104,102,2,0,0,47,49,5467,153,1333,9,5620,5521.27
2018,24,LIVINGSTON,0,SUNY,0,PUBLIC,1,4-Year/Grad,233000,800000051026,STATE UNIVERSITY OF NEW YORK COLLEGE AT GENESEO,5351,5351,0,143,139,4,0,0,48,46,5399,189,1338,7,5588,5465.07
2019,24,LIVINGSTON,0,SUNY,0,PUBLIC,1,4-Year/Grad,233000,800000051026,STATE UNIVERSITY OF NEW YORK COLLEGE AT GENESEO,5133,5133,0,141,136,5,0,0,48,56,5181,197,1226,8,5378,5250.4
2010,62,ULSTER,0,SUNY,0,PUBLIC,1,4-Year/Grad,233500,800000036164,STATE UNIVERSITY OF NEW YORK COLLEGE AT NEW PALTZ,5960,5956,4,492,445,47,0,0,522,780,6482,1272,1101,33,7754,6958
2011,62,ULSTER,0,SUNY,0,PUBLIC,1,4-Year/Grad,233500,800000036164,STATE UNIVERSITY OF NEW YORK COLLEGE AT NEW PALTZ,6194,6187,7,505,372,133,0,0,525,633,6719,1138,1162,0,7857,7140.53
2012,62,ULSTER,0,SUNY,0,PUBLIC,1,4-Year/Grad,233500,800000036164,STATE UNIVERSITY OF NEW YORK COLLEGE AT NEW PALTZ,6091,6081,10,482,358,124,0,0,498,584,6589,1066,1119,0,7655,6983.27
2013,62,ULSTER,0,SUNY,0,PUBLIC,1,4-Year/Grad,233500,800000036164,STATE UNIVERSITY OF NEW YORK COLLEGE AT NEW PALTZ,6060,6009,51,510,388,122,0,0,478,530,6538,1040,1104,0,7578,6920
2014,62,ULSTER,0,SUNY,0,PUBLIC,1,4-Year/Grad,233500,800000036164,STATE UNIVERSITY OF NEW YORK COLLEGE AT NEW PALTZ,6097,6050,47,545,414,131,0,0,484,566,6581,1111,1077,2,7692,6989.07
2015,62,ULSTER,0,SUNY,0,PUBLIC,1,4-Year/Grad,233500,800000036164,STATE UNIVERSITY OF NEW YORK COLLEGE AT NEW PALTZ,6165,6118,47,534,380,154,0,0,517,525,6682,1059,1087,68,7741,7070
2016,62,ULSTER,0,SUNY,0,PUBLIC,1,4-Year/Grad,233500,800000036164,STATE UNIVERSITY OF NEW YORK COLLEGE AT NEW PALTZ,6198,6197,1,519,385,134,0,0,434,477,6632,996,1089,69,7628,6995.8
2017,62,ULSTER,0,SUNY,0,PUBLIC,1,4-Year/Grad,233500,800000036164,STATE UNIVERSITY OF NEW YORK COLLEGE AT NEW PALTZ,6235,6234,1,498,382,116,0,0,403,429,6638,927,1100,55,7565,6975.6
2018,62,ULSTER,0,SUNY,0,PUBLIC,1,4-Year/Grad,233500,800000036164,STATE UNIVERSITY OF NEW YORK COLLEGE AT NEW PALTZ,6190,6188,2,502,398,104,0,0,449,467,6639,969,1149,62,7608,6993.13
2019,62,ULSTER,0,SUNY,0,PUBLIC,1,4-Year/Grad,233500,800000036164,STATE UNIVERSITY OF NEW YORK COLLEGE AT NEW PALTZ,6291,6290,1,965,382,583,0,0,488,462,6779,1427,1124,82,8206,7285.47
2010,28,NASSAU,0,SUNY,0,PUBLIC,1,4-Year/Grad,234000,800000048818,STATE UNIVERSITY OF NEW YORK COLLEGE AT OLD WESTBURY,3512,3296,216,682,570,112,0,0,103,58,3615,740,390,12,4355,3865.53
2011,28,NASSAU,0,SUNY,0,PUBLIC,1,4-Year/Grad,234000,800000048818,STATE UNIVERSITY OF NEW YORK COLLEGE AT OLD WESTBURY,3561,3530,31,669,581,88,0,0,131,98,3692,767,399,2,4459,3954.2
2012,28,NASSAU,0,SUNY,0,PUBLIC,1,4-Year/Grad,234000,800000048818,STATE UNIVERSITY OF NEW YORK COLLEGE AT OLD WESTBURY,3610,3570,40,607,507,100,0,0,106,99,3716,706,394,3,4422,3957.93
2013,28,NASSAU,0,SUNY,0,PUBLIC,1,4-Year/Grad,234000,800000048818,STATE UNIVERSITY OF NEW YORK COLLEGE AT OLD WESTBURY,3558,3529,29,603,516,87,0,0,99,107,3657,710,416,0,4367,3900.8
2014,28,NASSAU,0,SUNY,0,PUBLIC,1,4-Year/Grad,234000,800000048818,STATE UNIVERSITY OF NEW YORK COLLEGE AT OLD WESTBURY,3670,3636,34,645,537,108,0,0,118,71,3788,716,457,2,4504,4031.4
2015,28,NASSAU,0,SUNY,0,PUBLIC,1,4-Year/Grad,234000,800000048818,STATE UNIVERSITY OF NEW YORK COLLEGE AT OLD WESTBURY,3522,3490,32,603,508,95,0,0,134,94,3656,697,396,0,4353,3894.6
2016,28,NASSAU,0,SUNY,0,PUBLIC,1,4-Year/Grad,234000,800000048818,STATE UNIVERSITY OF NEW YORK COLLEGE AT OLD WESTBURY,3633,3589,44,611,497,114,0,0,126,93,3759,704,506,12,4463,3999.87
2017,28,NASSAU,0,SUNY,0,PUBLIC,1,4-Year/Grad,234000,800000048818,STATE UNIVERSITY OF NEW YORK COLLEGE AT OLD WESTBURY,4058,4007,51,577,474,103,0,0,164,112,4222,689,659,3,4911,4459.13
2018,28,NASSAU,0,SUNY,0,PUBLIC,1,4-Year/Grad,234000,800000048818,STATE UNIVERSITY OF NEW YORK COLLEGE AT OLD WESTBURY,4143,4108,35,765,537,228,0,0,168,135,4311,900,738,6,5211,4620
2019,28,NASSAU,0,SUNY,0,PUBLIC,1,4-Year/Grad,234000,800000048818,STATE UNIVERSITY OF NEW YORK COLLEGE AT OLD WESTBURY,4128,4097,31,702,576,126,0,0,149,171,4277,873,605,7,5150,4579.4
2010,47,OTSEGO,0,SUNY,0,PUBLIC,1,4-Year/Grad,234500,800000039836,STATE UNIVERSITY OF NEW YORK COLLEGE AT ONEONTA,5706,5693,13,116,87,29,0,0,83,84,5789,200,1132,8,5989,5861.27
2011,47,OTSEGO,0,SUNY,0,PUBLIC,1,4-Year/Grad,234500,800000039836,STATE UNIVERSITY OF NEW YORK COLLEGE AT ONEONTA,5738,5713,25,114,90,24,0,0,92,79,5830,193,1180,6,6023,5899.6
2012,47,OTSEGO,0,SUNY,0,PUBLIC,1,4-Year/Grad,234500,800000039836,STATE UNIVERSITY OF NEW YORK COLLEGE AT ONEONTA,5709,5699,10,128,105,23,0,0,116,88,5825,216,1147,2,6041,5902.87
2013,47,OTSEGO,0,SUNY,0,PUBLIC,1,4-Year/Grad,234500,800000039836,STATE UNIVERSITY OF NEW YORK COLLEGE AT ONEONTA,5675,5662,13,125,97,28,0,0,133,101,5808,226,1122,1,6034,5890.07
2014,47,OTSEGO,0,SUNY,0,PUBLIC,1,4-Year/Grad,234500,800000039836,STATE UNIVERSITY OF NEW YORK COLLEGE AT ONEONTA,5727,5711,16,109,92,17,0,0,121,144,5848,253,1108,2,6101,5941.93
2015,47,OTSEGO,0,SUNY,0,PUBLIC,1,4-Year/Grad,234500,800000039836,STATE UNIVERSITY OF NEW YORK COLLEGE AT ONEONTA,5754,5747,7,96,78,18,0,0,122,147,5876,243,1133,3,6119,5966.8
2016,47,OTSEGO,0,SUNY,0,PUBLIC,1,4-Year/Grad,234500,800000039836,STATE UNIVERSITY OF NEW YORK COLLEGE AT ONEONTA,5608,5604,4,122,105,17,0,0,122,204,5730,326,1123,7,6056,5852.27
2017,47,OTSEGO,0,SUNY,0,PUBLIC,1,4-Year/Grad,234500,800000039836,STATE UNIVERSITY OF NEW YORK COLLEGE AT ONEONTA,5828,5826,2,135,97,38,0,0,140,278,5968,413,1382,5,6381,6124.2
2018,47,OTSEGO,0,SUNY,0,PUBLIC,1,4-Year/Grad,234500,800000039836,STATE UNIVERSITY OF NEW YORK COLLEGE AT ONEONTA,5940,5936,4,126,85,41,0,0,96,389,6036,515,1328,1,6551,6233.6
2019,47,OTSEGO,0,SUNY,0,PUBLIC,1,4-Year/Grad,234500,800000039836,STATE UNIVERSITY OF NEW YORK COLLEGE AT ONEONTA,5942,5938,4,122,108,14,0,0,124,340,6066,462,1454,4,6528,6242.67
2010,46,OSWEGO,0,SUNY,0,PUBLIC,1,4-Year/Grad,235000,800000039957,STATE UNIVERSITY OF NEW YORK COLLEGE AT OSWEGO,6983,6979,4,394,364,30,0,0,411,509,7394,903,1388,27,8297,7728.93
2011,46,OSWEGO,0,SUNY,0,PUBLIC,1,4-Year/Grad,235000,800000039957,STATE UNIVERSITY OF NEW YORK COLLEGE AT OSWEGO,6992,6990,2,387,354,33,0,0,372,465,7364,852,1336,28,8216,7679
2012,46,OSWEGO,0,SUNY,0,PUBLIC,1,4-Year/Grad,235000,800000039957,STATE UNIVERSITY OF NEW YORK COLLEGE AT OSWEGO,6815,6813,2,336,301,35,0,0,331,439,7146,775,1272,25,7921,7433.6
2013,46,OSWEGO,0,SUNY,0,PUBLIC,1,4-Year/Grad,235000,800000039957,STATE UNIVERSITY OF NEW YORK COLLEGE AT OSWEGO,6954,6951,3,374,294,80,0,0,352,437,7306,811,1506,52,8117,7605.47
2014,46,OSWEGO,0,SUNY,0,PUBLIC,1,4-Year/Grad,235000,800000039957,STATE UNIVERSITY OF NEW YORK COLLEGE AT OSWEGO,6880,6832,48,313,271,42,0,0,332,509,7212,822,1440,32,8034,7519.93
2015,46,OSWEGO,0,SUNY,0,PUBLIC,1,4-Year/Grad,235000,800000039957,STATE UNIVERSITY OF NEW YORK COLLEGE AT OSWEGO,6778,6753,25,326,293,33,0,0,308,525,7086,851,1493,32,7937,7404.67
2016,46,OSWEGO,0,SUNY,0,PUBLIC,1,4-Year/Grad,235000,800000039957,STATE UNIVERSITY OF NEW YORK COLLEGE AT OSWEGO,6868,6868,0,282,245,37,0,0,317,537,7185,819,1440,25,8004,7493.8
2017,46,OSWEGO,0,SUNY,0,PUBLIC,1,4-Year/Grad,235000,800000039957,STATE UNIVERSITY OF NEW YORK COLLEGE AT OSWEGO,6836,6836,0,289,254,35,0,0,362,539,7198,828,1461,26,8026,7509.93
2018,46,OSWEGO,0,SUNY,0,PUBLIC,1,4-Year/Grad,235000,800000039957,STATE UNIVERSITY OF NEW YORK COLLEGE AT OSWEGO,6707,6705,2,303,263,40,0,0,321,544,7028,847,1481,28,7875,7346.6
2019,46,OSWEGO,0,SUNY,0,PUBLIC,1,4-Year/Grad,235000,800000039957,STATE UNIVERSITY OF NEW YORK COLLEGE AT OSWEGO,6515,6515,0,332,293,39,0,0,272,559,6787,891,1415,37,7678,7121.27
2017,42,ONONDAGA,0,SUNY,0,PUBLIC,1,4-Year/Grad,235010,800000085208,STATE UNIVERSITY COLLEGE OF OSWEGO - METRO CENTER,34,34,0,11,11,0,0,0,2,17,36,28,0,0,64,46.47
2018,42,ONONDAGA,0,SUNY,0,PUBLIC,1,4-Year/Grad,235010,800000085208,STATE UNIVERSITY COLLEGE OF OSWEGO - METRO CENTER,60,60,0,11,11,0,0,0,16,24,76,35,0,0,111,89.27
2019,42,ONONDAGA,0,SUNY,0,PUBLIC,1,4-Year/Grad,235010,800000085208,STATE UNIVERSITY COLLEGE OF OSWEGO - METRO CENTER,46,46,0,27,27,0,0,0,47,32,93,59,0,0,152,114.8
2010,09,CLINTON,0,SUNY,0,PUBLIC,1,4-Year/Grad,235500,800000053811,STATE UNIVERSITY COLLEGE AT PLATTSBURGH,5529,5502,27,330,244,86,0,0,324,258,5853,588,996,9,6441,6066.2
2011,09,CLINTON,0,SUNY,0,PUBLIC,1,4-Year/Grad,235500,800000053811,STATE UNIVERSITY COLLEGE AT PLATTSBURGH,5438,5423,15,384,311,73,0,0,313,215,5751,599,962,19,6350,5965
2012,09,CLINTON,0,SUNY,0,PUBLIC,1,4-Year/Grad,235500,800000053811,STATE UNIVERSITY COLLEGE AT PLATTSBURGH,5318,5301,17,388,322,66,0,0,296,165,5614,553,969,23,6167,5809.33
2013,09,CLINTON,0,SUNY,0,PUBLIC,1,4-Year/Grad,235500,800000053811,STATE UNIVERSITY COLLEGE AT PLATTSBURGH,5186,5145,41,453,349,104,0,0,272,140,5458,593,954,28,6051,5665
2014,09,CLINTON,0,SUNY,0,PUBLIC,1,4-Year/Grad,235500,800000053811,STATE UNIVERSITY COLLEGE AT PLATTSBURGH,5143,5078,65,422,352,70,0,0,248,155,5391,577,1036,23,5968,5593.67
2015,09,CLINTON,0,SUNY,0,PUBLIC,1,4-Year/Grad,235500,800000053811,STATE UNIVERSITY COLLEGE AT PLATTSBURGH,4960,4924,36,417,348,69,0,0,207,134,5167,551,964,26,5718,5359.6
2016,09,CLINTON,0,SUNY,0,PUBLIC,1,4-Year/Grad,235500,800000053811,STATE UNIVERSITY COLLEGE AT PLATTSBURGH,4671,4661,10,338,279,59,0,0,170,58,4841,396,1019,29,5237,4976.87
2017,09,CLINTON,0,SUNY,0,PUBLIC,1,4-Year/Grad,235500,800000053811,STATE UNIVERSITY COLLEGE AT PLATTSBURGH,4738,4724,14,382,317,65,0,0,208,76,4946,458,1108,21,5404,5103.73
2018,09,CLINTON,0,SUNY,0,PUBLIC,1,4-Year/Grad,235500,800000053811,STATE UNIVERSITY COLLEGE AT PLATTSBURGH,4701,4688,13,367,315,52,0,0,231,66,4932,433,1140,23,5365,5080.73
2019,09,CLINTON,0,SUNY,0,PUBLIC,1,4-Year/Grad,235500,800000053811,STATE UNIVERSITY COLLEGE AT PLATTSBURGH,4328,4314,14,393,332,61,0,0,202,87,4530,480,961,23,5010,4695.8
2016,63,WARREN,0,SUNY,0,PUBLIC,1,4-Year/Grad,235501,800000061811,SUC AT PLATTSBURGH AT ADIRONDACK COMMUNITY COLLEGE,151,151,0,55,55,0,0,0,21,56,172,111,0,0,283,212.73
2017,63,WARREN,0,SUNY,0,PUBLIC,1,4-Year/Grad,235501,800000061811,SUC AT PLATTSBURGH AT ADIRONDACK COMMUNITY COLLEGE,156,156,0,75,75,0,0,0,19,65,175,140,0,0,315,226
2018,63,WARREN,0,SUNY,0,PUBLIC,1,4-Year/Grad,235501,800000061811,SUC AT PLATTSBURGH AT ADIRONDACK COMMUNITY COLLEGE,152,152,0,77,74,3,0,0,39,71,191,148,0,0,339,245.07
2019,63,WARREN,0,SUNY,0,PUBLIC,1,4-Year/Grad,235501,800000061811,SUC AT PLATTSBURGH AT ADIRONDACK COMMUNITY COLLEGE,92,92,0,58,56,2,0,0,45,53,137,111,0,0,248,177.53
2010,51,SAINT LAWRENCE,0,SUNY,0,PUBLIC,1,4-Year/Grad,236000,800000038744,STATE UNIVERSITY OF NEW YORK COLLEGE AT POTSDAM,3779,3763,16,123,100,23,0,0,350,161,4129,284,904,5,4413,4234.4
2011,51,SAINT LAWRENCE,0,SUNY,0,PUBLIC,1,4-Year/Grad,236000,800000038744,STATE UNIVERSITY OF NEW YORK COLLEGE AT POTSDAM,3827,3824,3,125,94,31,0,0,298,145,4125,270,898,6,4395,4224.67
2012,51,SAINT LAWRENCE,0,SUNY,0,PUBLIC,1,4-Year/Grad,236000,800000038744,STATE UNIVERSITY OF NEW YORK COLLEGE AT POTSDAM,3762,3762,0,106,88,18,0,0,230,126,3992,232,883,8,4224,4077.73
2013,51,SAINT LAWRENCE,0,SUNY,0,PUBLIC,1,4-Year/Grad,236000,800000038744,STATE UNIVERSITY OF NEW YORK COLLEGE AT POTSDAM,3596,3595,1,111,88,23,0,0,221,114,3817,225,818,7,4042,3899.6
2014,51,SAINT LAWRENCE,0,SUNY,0,PUBLIC,1,4-Year/Grad,236000,800000038744,STATE UNIVERSITY OF NEW YORK COLLEGE AT POTSDAM,3573,3573,0,108,96,12,0,0,194,104,3767,212,820,10,3979,3844.6
2015,51,SAINT LAWRENCE,0,SUNY,0,PUBLIC,1,4-Year/Grad,236000,800000038744,STATE UNIVERSITY OF NEW YORK COLLEGE AT POTSDAM,3504,3504,0,110,91,19,0,0,190,100,3694,210,848,6,3904,3770.67
2016,51,SAINT LAWRENCE,0,SUNY,0,PUBLIC,1,4-Year/Grad,236000,800000038744,STATE UNIVERSITY OF NEW YORK COLLEGE AT POTSDAM,3321,3320,1,95,86,9,0,0,190,90,3511,185,784,5,3696,3578.67
2017,51,SAINT LAWRENCE,0,SUNY,0,PUBLIC,1,4-Year/Grad,236000,800000038744,STATE UNIVERSITY OF NEW YORK COLLEGE AT POTSDAM,3196,3195,1,125,101,24,0,0,186,80,3382,205,779,7,3587,3455.67
2018,51,SAINT LAWRENCE,0,SUNY,0,PUBLIC,1,4-Year/Grad,236000,800000038744,STATE UNIVERSITY OF NEW YORK COLLEGE AT POTSDAM,3221,3218,3,86,69,17,0,0,169,54,3390,140,873,1,3530,3440.27
2019,51,SAINT LAWRENCE,0,SUNY,0,PUBLIC,1,4-Year/Grad,236000,800000038744,STATE UNIVERSITY OF NEW YORK COLLEGE AT POTSDAM,2977,2977,0,86,78,8,0,0,196,80,3173,166,620,2,3339,3233.67
2010,66,WESTCHESTER,0,SUNY,0,PUBLIC,1,4-Year/Grad,236500,800000035407,STATE UNIVERSITY OF NEW YORK COLLEGE AT PURCHASE,3675,3615,60,369,202,167,0,0,109,13,3784,382,691,67,4166,3912.2
2011,66,WESTCHESTER,0,SUNY,0,PUBLIC,1,4-Year/Grad,236500,800000035407,STATE UNIVERSITY OF NEW YORK COLLEGE AT PURCHASE,3733,3733,0,471,392,79,0,0,109,11,3842,482,827,113,4324,4003.4
2012,66,WESTCHESTER,0,SUNY,0,PUBLIC,1,4-Year/Grad,236500,800000035407,STATE UNIVERSITY OF NEW YORK COLLEGE AT PURCHASE,3721,3660,61,407,240,167,0,0,101,11,3822,418,712,78,4240,3962.07
2013,66,WESTCHESTER,0,SUNY,0,PUBLIC,1,4-Year/Grad,236500,800000035407,STATE UNIVERSITY OF NEW YORK COLLEGE AT PURCHASE,3847,3799,48,392,218,174,0,0,102,12,3949,404,821,173,4353,4084.47
2014,66,WESTCHESTER,0,SUNY,0,PUBLIC,1,4-Year/Grad,236500,800000035407,STATE UNIVERSITY OF NEW YORK COLLEGE AT PURCHASE,3746,3694,52,378,231,147,0,0,87,14,3833,392,761,55,4225,3964.6
2015,66,WESTCHESTER,0,SUNY,0,PUBLIC,1,4-Year/Grad,236500,800000035407,STATE UNIVERSITY OF NEW YORK COLLEGE AT PURCHASE,3678,3640,38,399,274,125,0,0,87,5,3765,404,794,66,4169,3900
2016,66,WESTCHESTER,0,SUNY,0,PUBLIC,1,4-Year/Grad,236500,800000035407,STATE UNIVERSITY OF NEW YORK COLLEGE AT PURCHASE,3673,3642,31,380,259,121,0,0,97,6,3770,386,723,17,4156,3899.07
2017,66,WESTCHESTER,0,SUNY,0,PUBLIC,1,4-Year/Grad,236500,800000035407,STATE UNIVERSITY OF NEW YORK COLLEGE AT PURCHASE,3750,3734,16,340,245,95,0,0,97,7,3847,347,760,3,4194,3963.13
2018,66,WESTCHESTER,0,SUNY,0,PUBLIC,1,4-Year/Grad,236500,800000035407,STATE UNIVERSITY OF NEW YORK COLLEGE AT PURCHASE,3767,3756,11,367,268,99,0,0,91,9,3858,376,882,21,4234,3983.93
2019,66,WESTCHESTER,0,SUNY,0,PUBLIC,1,4-Year/Grad,236500,800000035407,STATE UNIVERSITY OF NEW YORK COLLEGE AT PURCHASE,3708,3696,12,342,270,72,0,0,97,9,3805,351,792,17,4156,3922.6
2010,42,ONONDAGA,0,SUNY,0,PUBLIC,1,4-Year/Grad,240500,800000040738,STATE UNIVERSITY OF NEW YORK COLLEGE OF ENVIRONMENTAL SCIENCE AND FORESTRY,1575,1569,6,617,41,576,0,0,316,174,1891,791,256,3,2682,2166.27
2011,42,ONONDAGA,0,SUNY,0,PUBLIC,1,4-Year/Grad,240500,800000040738,STATE UNIVERSITY OF NEW YORK COLLEGE OF ENVIRONMENTAL SCIENCE AND FORESTRY,1628,1628,0,539,25,514,0,0,319,194,1947,733,287,1,2680,2204.27
2012,42,ONONDAGA,0,SUNY,0,PUBLIC,1,4-Year/Grad,240500,800000040738,STATE UNIVERSITY OF NEW YORK COLLEGE OF ENVIRONMENTAL SCIENCE AND FORESTRY,1670,1670,0,75,58,17,0,0,328,263,1998,338,325,1,2336,2128.2
2013,42,ONONDAGA,0,SUNY,0,PUBLIC,1,4-Year/Grad,240500,800000040738,STATE UNIVERSITY OF NEW YORK COLLEGE OF ENVIRONMENTAL SCIENCE AND FORESTRY,1647,1644,3,55,50,5,0,0,319,208,1966,263,288,0,2229,2067.53
2014,42,ONONDAGA,0,SUNY,0,PUBLIC,1,4-Year/Grad,240500,800000040738,STATE UNIVERSITY OF NEW YORK COLLEGE OF ENVIRONMENTAL SCIENCE AND FORESTRY,1671,1668,3,57,50,7,0,0,285,187,1956,244,329,2,2200,2049.8
2015,42,ONONDAGA,0,SUNY,0,PUBLIC,1,4-Year/Grad,240500,800000040738,STATE UNIVERSITY OF NEW YORK COLLEGE OF ENVIRONMENTAL SCIENCE AND FORESTRY,1726,1720,6,29,26,3,0,0,281,186,2007,215,318,2,2222,2091.07
2016,42,ONONDAGA,0,SUNY,0,PUBLIC,1,4-Year/Grad,240500,800000040738,STATE UNIVERSITY OF NEW YORK COLLEGE OF ENVIRONMENTAL SCIENCE AND FORESTRY,1711,1711,0,40,35,5,0,0,255,180,1966,220,326,1,2186,2051.33
2017,42,ONONDAGA,0,SUNY,0,PUBLIC,1,4-Year/Grad,240500,800000040738,STATE UNIVERSITY OF NEW YORK COLLEGE OF ENVIRONMENTAL SCIENCE AND FORESTRY,1747,1746,1,598,50,548,0,0,344,68,2091,666,329,0,2757,2317.53
2018,42,ONONDAGA,0,SUNY,0,PUBLIC,1,4-Year/Grad,240500,800000040738,STATE UNIVERSITY OF NEW YORK COLLEGE OF ENVIRONMENTAL SCIENCE AND FORESTRY,1777,1777,0,48,42,6,0,0,231,164,2008,212,383,3,2220,2089.6
2019,42,ONONDAGA,0,SUNY,0,PUBLIC,1,4-Year/Grad,240500,800000040738,STATE UNIVERSITY OF NEW YORK COLLEGE OF ENVIRONMENTAL SCIENCE AND FORESTRY,1747,1747,0,404,63,341,0,0,221,176,1968,580,353,2,2548,2173.07
2010,41,ONEIDA,0,SUNY,0,PUBLIC,1,4-Year/Grad,240700,800000041209,SUNY POLYTECHNIC INSTITUTE,1521,1501,20,621,438,183,0,0,183,496,1704,1117,205,1,2821,2109.4
2011,41,ONEIDA,0,SUNY,0,PUBLIC,1,4-Year/Grad,240700,800000041209,SUNY POLYTECHNIC INSTITUTE,1353,1331,22,511,400,111,0,0,151,493,1504,1004,198,0,2508,1871.53
2012,41,ONEIDA,0,SUNY,0,PUBLIC,1,4-Year/Grad,240700,800000041209,SUNY POLYTECHNIC INSTITUTE,1272,1255,17,421,300,121,0,0,171,513,1443,934,198,0,2377,1788.53
2013,41,ONEIDA,0,SUNY,0,PUBLIC,1,4-Year/Grad,240700,800000041209,SUNY POLYTECHNIC INSTITUTE,1425,1417,8,379,297,82,0,0,195,481,1620,860,275,0,2480,1938.73
2014,41,ONEIDA,0,SUNY,0,PUBLIC,1,4-Year/Grad,240700,800000041209,SUNY POLYTECHNIC INSTITUTE,1646,1601,45,389,277,112,0,0,194,509,1840,898,360,0,2738,2173.27
2015,41,ONEIDA,0,SUNY,0,PUBLIC,1,4-Year/Grad,240700,800000041209,SUNY POLYTECHNIC INSTITUTE,1742,1720,22,340,237,103,0,0,165,545,1907,885,347,0,2792,2238.33
2016,41,ONEIDA,0,SUNY,0,PUBLIC,1,4-Year/Grad,240700,800000041209,SUNY POLYTECHNIC INSTITUTE,1698,1688,10,314,208,106,0,0,196,497,1894,811,314,0,2705,2197.47
2017,41,ONEIDA,0,SUNY,0,PUBLIC,1,4-Year/Grad,240700,800000041209,SUNY POLYTECHNIC INSTITUTE,1860,1851,9,324,223,101,0,0,250,499,2110,823,463,0,2933,2417.6
2018,41,ONEIDA,0,SUNY,0,PUBLIC,1,4-Year/Grad,240700,800000041209,SUNY POLYTECHNIC INSTITUTE,1928,1927,1,332,197,135,0,0,226,550,2154,882,424,0,3036,2484.67
2019,41,ONEIDA,0,SUNY,0,PUBLIC,1,4-Year/Grad,240700,800000041209,SUNY POLYTECHNIC INSTITUTE,1903,1901,2,313,176,137,0,0,262,528,2165,841,405,37,3006,2480.53
2010,32,BRONX,0,SUNY,0,PUBLIC,1,4-Year/Grad,241000,800000046464,SUNY MARITIME COLLEGE,1545,1545,0,142,101,41,0,0,102,91,1647,233,352,3,1880,1730.73
2011,32,BRONX,0,SUNY,0,PUBLIC,1,4-Year/Grad,241000,800000046464,SUNY MARITIME COLLEGE,1565,1565,0,96,73,23,0,0,102,60,1667,156,367,0,1823,1723
2012,32,BRONX,0,SUNY,0,PUBLIC,1,4-Year/Grad,241000,800000046464,SUNY MARITIME COLLEGE,1519,1519,0,95,59,36,0,0,88,59,1607,154,329,0,1761,1662.27
2013,32,BRONX,0,SUNY,0,PUBLIC,1,4-Year/Grad,241000,800000046464,SUNY MARITIME COLLEGE,1517,1513,4,84,52,32,0,0,95,59,1612,143,330,0,1755,1663.6
2014,32,BRONX,0,SUNY,0,PUBLIC,1,4-Year/Grad,241000,800000046464,SUNY MARITIME COLLEGE,1591,1579,12,50,45,5,0,0,97,61,1688,111,349,0,1799,1729.07
2015,32,BRONX,0,SUNY,0,PUBLIC,1,4-Year/Grad,241000,800000046464,SUNY MARITIME COLLEGE,1630,1621,9,46,46,0,0,0,121,63,1751,109,334,0,1860,1791.53
2016,32,BRONX,0,SUNY,0,PUBLIC,1,4-Year/Grad,241000,800000046464,SUNY MARITIME COLLEGE,1590,1585,5,45,41,4,0,0,111,86,1701,131,314,4,1832,1750.4
2017,32,BRONX,0,SUNY,0,PUBLIC,1,4-Year/Grad,241000,800000046464,SUNY MARITIME COLLEGE,1581,1576,5,60,57,3,0,0,87,66,1668,126,347,2,1794,1714.4
2018,32,BRONX,0,SUNY,0,PUBLIC,1,4-Year/Grad,241000,800000046464,SUNY MARITIME COLLEGE,1542,1538,4,44,43,1,0,0,77,71,1619,115,351,0,1734,1662.07
2019,32,BRONX,0,SUNY,0,PUBLIC,1,4-Year/Grad,241000,800000046464,SUNY MARITIME COLLEGE,1474,1465,9,48,45,3,0,0,84,68,1558,116,353,2,1674,1601.2
2010,31,NEW YORK,0,SUNY,0,PUBLIC,1,4-Year/Grad,241500,800000047769,STATE UNIVERSITY OF NEW YORK COLLEGE OF OPTOMETRY,0,0,0,0,0,0,291,0,11,1,302,1,0,0,303,302.4
2011,31,NEW YORK,0,SUNY,0,PUBLIC,1,4-Year/Grad,241500,800000047769,STATE UNIVERSITY OF NEW YORK COLLEGE OF OPTOMETRY,0,0,0,0,0,0,302,1,12,2,314,3,0,0,317,315.2
2012,31,NEW YORK,0,SUNY,0,PUBLIC,1,4-Year/Grad,241500,800000047769,STATE UNIVERSITY OF NEW YORK COLLEGE OF OPTOMETRY,0,0,0,0,0,0,314,0,15,1,329,1,0,0,330,329.4
2013,31,NEW YORK,0,SUNY,0,PUBLIC,1,4-Year/Grad,241500,800000047769,STATE UNIVERSITY OF NEW YORK COLLEGE OF OPTOMETRY,0,0,0,0,0,0,326,0,14,3,340,3,0,0,343,341.2
2014,31,NEW YORK,0,SUNY,0,PUBLIC,1,4-Year/Grad,241500,800000047769,STATE UNIVERSITY OF NEW YORK COLLEGE OF OPTOMETRY,0,0,0,0,0,0,347,0,16,0,363,0,0,0,363,363
2015,31,NEW YORK,0,SUNY,0,PUBLIC,1,4-Year/Grad,241500,800000047769,STATE UNIVERSITY OF NEW YORK COLLEGE OF OPTOMETRY,0,0,0,0,0,0,367,0,16,0,383,0,0,0,383,383
2016,31,NEW YORK,0,SUNY,0,PUBLIC,1,4-Year/Grad,241500,800000047769,STATE UNIVERSITY OF NEW YORK COLLEGE OF OPTOMETRY,0,0,0,1,0,1,386,0,14,2,400,3,0,0,403,401.13
2017,31,NEW YORK,0,SUNY,0,PUBLIC,1,4-Year/Grad,241500,800000047769,STATE UNIVERSITY OF NEW YORK COLLEGE OF OPTOMETRY,0,0,0,0,0,0,395,0,16,0,411,0,0,0,411,411
2018,31,NEW YORK,0,SUNY,0,PUBLIC,1,4-Year/Grad,241500,800000047769,STATE UNIVERSITY OF NEW YORK COLLEGE OF OPTOMETRY,0,0,0,0,0,0,394,0,14,0,408,0,0,0,408,408
2019,31,NEW YORK,0,SUNY,0,PUBLIC,1,4-Year/Grad,241500,800000047769,STATE UNIVERSITY OF NEW YORK COLLEGE OF OPTOMETRY,0,0,0,0,0,0,392,1,16,0,408,1,0,0,409,408.4
2010,61,TOMPKINS,0,SUNY,0,PUBLIC,1,4-Year/Grad,250000,800000069831,NEW YORK STATE STATUTORY COLLEGES AT CORNELL UNIVERSITY-TOTAL,5566,5566,0,23,23,0,363,0,1553,0,7482,23,1114,1,7505,7489.67
2011,61,TOMPKINS,0,SUNY,0,PUBLIC,1,4-Year/Grad,250000,800000069831,NEW YORK STATE STATUTORY COLLEGES AT CORNELL UNIVERSITY-TOTAL,5608,5574,34,12,12,0,379,0,1461,42,7448,54,1157,0,7502,7468.8
2012,61,TOMPKINS,0,SUNY,0,PUBLIC,1,4-Year/Grad,250000,800000069831,NEW YORK STATE STATUTORY COLLEGES AT CORNELL UNIVERSITY-TOTAL,5653,5607,46,11,11,0,400,0,1475,36,7528,47,1142,0,7575,7546.07
2013,61,TOMPKINS,0,SUNY,0,PUBLIC,1,4-Year/Grad,250000,800000069831,NEW YORK STATE STATUTORY COLLEGES AT CORNELL UNIVERSITY-TOTAL,5741,5700,41,7,7,0,408,0,1634,34,7783,41,1140,0,7824,7798.93
2014,61,TOMPKINS,0,SUNY,0,PUBLIC,1,4-Year/Grad,250000,800000069831,NEW YORK STATE STATUTORY COLLEGES AT CORNELL UNIVERSITY-TOTAL,5657,5602,55,5,5,0,421,0,1531,46,7609,51,1113,0,7660,7629.07
2015,61,TOMPKINS,0,SUNY,0,PUBLIC,1,4-Year/Grad,250000,800000069831,NEW YORK STATE STATUTORY COLLEGES AT CORNELL UNIVERSITY-TOTAL,5660,5607,53,6,6,0,421,0,1570,53,7651,59,1085,0,7710,7674.2
2016,61,TOMPKINS,0,SUNY,0,PUBLIC,1,4-Year/Grad,250010,800000036404,NEW YORK STATE COLLEGE OF AGRICULTURE AND LIFE SCIENCES AT CORNELL,3565,3518,47,4,4,0,0,0,840,25,4405,29,673,0,4434,4416.33
2017,61,TOMPKINS,0,SUNY,0,PUBLIC,1,4-Year/Grad,250010,800000036404,NEW YORK STATE COLLEGE OF AGRICULTURE AND LIFE SCIENCES AT CORNELL,3683,3638,45,4,4,0,0,0,894,25,4577,29,694,0,4606,4588.33
2018,61,TOMPKINS,0,SUNY,0,PUBLIC,1,4-Year/Grad,250010,800000036404,NEW YORK STATE COLLEGE OF AGRICULTURE AND LIFE SCIENCES AT CORNELL,3773,3737,36,4,4,0,0,0,993,26,4766,30,655,0,4796,4777.73
2019,61,TOMPKINS,0,SUNY,0,PUBLIC,1,4-Year/Grad,250010,800000036404,NEW YORK STATE COLLEGE OF AGRICULTURE AND LIFE SCIENCES AT CORNELL,3762,3725,37,3,3,0,0,0,1058,26,4820,29,715,0,4849,4831.4
2016,61,TOMPKINS,0,SUNY,0,PUBLIC,1,4-Year/Grad,250020,800000036401,NEW YORK STATE COLLEGE OF HUMAN ECOLOGY AT CORNELL UNIVERSITY,1215,1202,13,0,0,0,0,0,398,12,1613,12,255,0,1625,1617.8
2017,61,TOMPKINS,0,SUNY,0,PUBLIC,1,4-Year/Grad,250020,800000036401,NEW YORK STATE COLLEGE OF HUMAN ECOLOGY AT CORNELL UNIVERSITY,1223,1208,15,0,0,0,0,0,414,15,1637,15,269,0,1652,1643
2018,61,TOMPKINS,0,SUNY,0,PUBLIC,1,4-Year/Grad,250020,800000036401,NEW YORK STATE COLLEGE OF HUMAN ECOLOGY AT CORNELL UNIVERSITY,1221,1204,17,0,0,0,0,0,391,12,1612,12,276,0,1624,1616.8
2019,61,TOMPKINS,0,SUNY,0,PUBLIC,1,4-Year/Grad,250020,800000036401,NEW YORK STATE COLLEGE OF HUMAN ECOLOGY AT CORNELL UNIVERSITY,1146,1138,8,0,0,0,0,0,415,14,1561,14,280,0,1575,1566.6
2016,61,TOMPKINS,0,SUNY,0,PUBLIC,1,4-Year/Grad,250030,800000036402,NEW YORK STATE SCHOOL OF INDUSTRIAL AND LABOR RELATIONS AT CORNELL,998,983,15,1,1,0,0,0,210,11,1208,12,157,0,1220,1212.73
2017,61,TOMPKINS,0,SUNY,0,PUBLIC,1,4-Year/Grad,250030,800000036402,NEW YORK STATE SCHOOL OF INDUSTRIAL AND LABOR RELATIONS AT CORNELL,1004,986,18,0,0,0,0,0,220,6,1224,6,155,0,1230,1226.4
2018,61,TOMPKINS,0,SUNY,0,PUBLIC,1,4-Year/Grad,250030,800000036402,NEW YORK STATE SCHOOL OF INDUSTRIAL AND LABOR RELATIONS AT CORNELL,977,965,12,0,0,0,0,0,219,9,1196,9,161,0,1205,1199.6
2019,61,TOMPKINS,0,SUNY,0,PUBLIC,1,4-Year/Grad,250030,800000036402,NEW YORK STATE SCHOOL OF INDUSTRIAL AND LABOR RELATIONS AT CORNELL,970,960,10,0,0,0,0,0,238,4,1208,4,159,0,1212,1209.6
2016,61,TOMPKINS,0,SUNY,0,PUBLIC,1,4-Year/Grad,250040,800000036403,NEW YORK STATE COLLEGE OF VETERINARY MEDICINE AT CORNELL UNIVERSITY,0,0,0,0,0,0,422,0,107,6,529,6,0,0,535,531.4
2017,61,TOMPKINS,0,SUNY,0,PUBLIC,1,4-Year/Grad,250040,800000036403,NEW YORK STATE COLLEGE OF VETERINARY MEDICINE AT CORNELL UNIVERSITY,0,0,0,0,0,0,436,0,144,5,580,5,0,0,585,582
2018,61,TOMPKINS,0,SUNY,0,PUBLIC,1,4-Year/Grad,250040,800000036403,NEW YORK STATE COLLEGE OF VETERINARY MEDICINE AT CORNELL UNIVERSITY,0,0,0,0,0,0,456,0,159,9,615,9,0,0,624,618.6
2019,61,TOMPKINS,0,SUNY,0,PUBLIC,1,4-Year/Grad,250040,800000036403,NEW YORK STATE COLLEGE OF VETERINARY MEDICINE AT CORNELL UNIVERSITY,0,0,0,0,0,0,468,0,175,14,643,14,0,0,657,648.6
2010,02,ALLEGANY,0,SUNY,0,PUBLIC,1,4-Year/Grad,251000,800000055242,NYS COLLEGE OF CERAMICS AT ALFRED UNIVERSITY,631,625,6,16,11,5,0,0,69,11,700,27,148,0,727,709.73
2011,02,ALLEGANY,0,SUNY,0,PUBLIC,1,4-Year/Grad,251000,800000055242,NYS COLLEGE OF CERAMICS AT ALFRED UNIVERSITY,632,629,3,16,8,8,0,0,68,17,700,33,146,0,733,712.13
2012,02,ALLEGANY,0,SUNY,0,PUBLIC,1,4-Year/Grad,251000,800000055242,NYS COLLEGE OF CERAMICS AT ALFRED UNIVERSITY,609,609,0,12,8,4,0,0,63,17,672,29,137,0,701,682.8
2013,02,ALLEGANY,0,SUNY,0,PUBLIC,1,4-Year/Grad,251000,800000055242,NYS COLLEGE OF CERAMICS AT ALFRED UNIVERSITY,593,593,0,18,12,6,0,0,71,21,664,39,131,0,703,678.4
2014,02,ALLEGANY,0,SUNY,0,PUBLIC,1,4-Year/Grad,251000,800000055242,NYS COLLEGE OF CERAMICS AT ALFRED UNIVERSITY,539,539,0,16,12,4,0,0,77,13,616,29,121,0,645,626.53
2015,02,ALLEGANY,0,SUNY,0,PUBLIC,1,4-Year/Grad,251000,800000055242,NYS COLLEGE OF CERAMICS AT ALFRED UNIVERSITY,552,537,15,16,14,2,0,0,71,16,623,32,136,0,655,634.73
2016,02,ALLEGANY,0,SUNY,0,PUBLIC,1,4-Year/Grad,251000,800000055242,NYS COLLEGE OF CERAMICS AT ALFRED UNIVERSITY,500,493,7,10,6,4,0,0,56,15,556,25,92,3,581,565.33
2017,02,ALLEGANY,0,SUNY,0,PUBLIC,1,4-Year/Grad,251000,800000055242,NYS COLLEGE OF CERAMICS AT ALFRED UNIVERSITY,481,473,8,21,17,4,0,0,54,6,535,27,124,0,562,544.4
2018,02,ALLEGANY,0,SUNY,0,PUBLIC,1,4-Year/Grad,251000,800000055242,NYS COLLEGE OF CERAMICS AT ALFRED UNIVERSITY,517,511,6,16,11,5,0,0,74,6,591,22,125,0,613,598.73
2019,02,ALLEGANY,0,SUNY,0,PUBLIC,1,4-Year/Grad,251000,800000055242,NYS COLLEGE OF CERAMICS AT ALFRED UNIVERSITY,485,482,3,12,10,2,0,0,71,10,556,22,114,0,578,564
2010,02,ALLEGANY,0,SUNY,0,PUBLIC,1,4-Year/Grad,260500,800000055244,SUNY COLLEGE OF TECHNOLOGY AT ALFRED,3359,3358,1,350,278,72,0,0,0,0,3359,350,1271,49,3709,3475.67
2011,02,ALLEGANY,0,SUNY,0,PUBLIC,1,4-Year/Grad,260500,800000055244,SUNY COLLEGE OF TECHNOLOGY AT ALFRED,3277,3277,0,339,255,84,0,0,0,0,3277,339,1077,13,3616,3390
2012,02,ALLEGANY,0,SUNY,0,PUBLIC,1,4-Year/Grad,260500,800000055244,SUNY COLLEGE OF TECHNOLOGY AT ALFRED,3212,3210,2,316,251,65,0,0,0,0,3212,316,1097,44,3528,3317.33
2013,02,ALLEGANY,0,SUNY,0,PUBLIC,1,4-Year/Grad,260500,800000055244,SUNY COLLEGE OF TECHNOLOGY AT ALFRED,3222,3218,4,333,276,57,0,0,0,0,3222,333,1094,7,3555,3333
2014,02,ALLEGANY,0,SUNY,0,PUBLIC,1,4-Year/Grad,260500,800000055244,SUNY COLLEGE OF TECHNOLOGY AT ALFRED,3329,3326,3,332,281,51,0,0,0,0,3329,332,1080,37,3661,3439.67
2015,02,ALLEGANY,0,SUNY,0,PUBLIC,1,4-Year/Grad,260500,800000055244,SUNY COLLEGE OF TECHNOLOGY AT ALFRED,3378,3376,2,321,293,28,0,0,0,0,3378,321,1053,5,3699,3485
2016,02,ALLEGANY,0,SUNY,0,PUBLIC,1,4-Year/Grad,260500,800000055244,SUNY COLLEGE OF TECHNOLOGY AT ALFRED,2691,2689,2,282,261,21,0,0,0,0,2691,282,821,15,2973,2785
2017,02,ALLEGANY,0,SUNY,0,PUBLIC,1,4-Year/Grad,260500,800000055244,SUNY COLLEGE OF TECHNOLOGY AT ALFRED,2628,2627,1,286,266,20,0,0,0,0,2628,286,768,13,2914,2723.33
2018,02,ALLEGANY,0,SUNY,0,PUBLIC,1,4-Year/Grad,260500,800000055244,SUNY COLLEGE OF TECHNOLOGY AT ALFRED,2692,2691,1,281,266,15,0,0,0,0,2692,281,839,11,2973,2785.67
2019,02,ALLEGANY,0,SUNY,0,PUBLIC,1,4-Year/Grad,260500,800000055244,SUNY COLLEGE OF TECHNOLOGY AT ALFRED,2631,2631,0,294,274,20,0,0,0,0,2631,294,767,18,2925,2729
2016,02,ALLEGANY,0,SUNY,0,PUBLIC,1,4-Year/Grad,260510,800000055111,SUNY COLLEGE OF  TECHNOLOGY AT ALFRED WELLSVILLE CAMPUS,756,756,0,6,6,0,0,0,0,0,756,6,341,0,762,758
2017,02,ALLEGANY,0,SUNY,0,PUBLIC,1,4-Year/Grad,260510,800000055111,SUNY COLLEGE OF  TECHNOLOGY AT ALFRED WELLSVILLE CAMPUS,768,768,0,4,4,0,0,0,0,0,768,4,348,0,772,769.33
2018,02,ALLEGANY,0,SUNY,0,PUBLIC,1,4-Year/Grad,260510,800000055111,SUNY COLLEGE OF  TECHNOLOGY AT ALFRED WELLSVILLE CAMPUS,764,764,0,0,0,0,0,0,0,0,764,0,376,0,764,764
2019,02,ALLEGANY,0,SUNY,0,PUBLIC,1,4-Year/Grad,260510,800000055111,SUNY COLLEGE OF  TECHNOLOGY AT ALFRED WELLSVILLE CAMPUS,851,851,0,4,4,0,0,0,0,0,851,4,405,0,855,852.33
2010,51,SAINT LAWRENCE,0,SUNY,0,PUBLIC,1,4-Year/Grad,261000,800000038903,SUNY COLLEGE OF TECHNOLOGY AT CANTON,2773,2773,0,882,521,361,0,0,0,0,2773,882,932,42,3655,3067
2011,51,SAINT LAWRENCE,0,SUNY,0,PUBLIC,1,4-Year/Grad,261000,800000038903,SUNY COLLEGE OF TECHNOLOGY AT CANTON,2964,2964,0,815,534,281,0,0,0,0,2964,815,953,28,3779,3235.67
2012,51,SAINT LAWRENCE,0,SUNY,0,PUBLIC,1,4-Year/Grad,261000,800000038903,SUNY COLLEGE OF TECHNOLOGY AT CANTON,3087,3087,0,693,541,152,0,0,0,0,3087,693,989,27,3780,3318
2013,51,SAINT LAWRENCE,0,SUNY,0,PUBLIC,1,4-Year/Grad,261000,800000038903,SUNY COLLEGE OF TECHNOLOGY AT CANTON,2938,2938,0,574,416,158,0,0,0,0,2938,574,772,15,3512,3129.33
2014,51,SAINT LAWRENCE,0,SUNY,0,PUBLIC,1,4-Year/Grad,261000,800000038903,SUNY COLLEGE OF TECHNOLOGY AT CANTON,2793,2793,0,489,347,142,0,0,0,0,2793,489,726,13,3282,2956
2015,51,SAINT LAWRENCE,0,SUNY,0,PUBLIC,1,4-Year/Grad,261000,800000038903,SUNY COLLEGE OF TECHNOLOGY AT CANTON,2641,2640,1,540,401,139,0,0,0,0,2641,540,645,15,3181,2821
2016,51,SAINT LAWRENCE,0,SUNY,0,PUBLIC,1,4-Year/Grad,261000,800000038903,SUNY COLLEGE OF TECHNOLOGY AT CANTON,2676,2676,0,565,418,147,0,0,0,0,2676,565,694,24,3241,2864.33
2017,51,SAINT LAWRENCE,0,SUNY,0,PUBLIC,1,4-Year/Grad,261000,800000038903,SUNY COLLEGE OF TECHNOLOGY AT CANTON,2657,2657,0,523,410,113,0,0,0,0,2657,523,690,6,3180,2831.33
2018,51,SAINT LAWRENCE,0,SUNY,0,PUBLIC,1,4-Year/Grad,261000,800000038903,SUNY COLLEGE OF TECHNOLOGY AT CANTON,2743,2743,0,473,384,89,0,0,0,0,2743,473,723,11,3216,2900.67
2019,51,SAINT LAWRENCE,0,SUNY,0,PUBLIC,1,4-Year/Grad,261000,800000038903,SUNY COLLEGE OF TECHNOLOGY AT CANTON,2784,2783,1,444,358,86,0,0,0,0,2784,444,705,7,3228,2932
2010,54,SCHOHARIE,0,SUNY,0,PUBLIC,1,4-Year/Grad,261500,800000038227,SUNY COLLEGE OF AGRICULTURE AND TECHNOLOGY AT COBLESKILL,2401,2395,6,165,121,44,0,0,0,0,2401,165,775,22,2566,2456
2011,54,SCHOHARIE,0,SUNY,0,PUBLIC,1,4-Year/Grad,261500,800000038227,SUNY COLLEGE OF AGRICULTURE AND TECHNOLOGY AT COBLESKILL,2383,2383,0,149,115,34,0,0,0,0,2383,149,756,5,2532,2432.67
2012,54,SCHOHARIE,0,SUNY,0,PUBLIC,1,4-Year/Grad,261500,800000038227,SUNY COLLEGE OF AGRICULTURE AND TECHNOLOGY AT COBLESKILL,2332,2325,7,160,124,36,0,0,0,0,2332,160,751,3,2492,2385.33
2013,54,SCHOHARIE,0,SUNY,0,PUBLIC,1,4-Year/Grad,261500,800000038227,SUNY COLLEGE OF AGRICULTURE AND TECHNOLOGY AT COBLESKILL,2267,2264,3,186,147,39,0,0,0,0,2267,186,755,20,2453,2329
2014,54,SCHOHARIE,0,SUNY,0,PUBLIC,1,4-Year/Grad,261500,800000038227,SUNY COLLEGE OF AGRICULTURE AND TECHNOLOGY AT COBLESKILL,2413,2410,3,122,102,20,0,0,0,0,2413,122,780,2,2535,2453.67
2015,54,SCHOHARIE,0,SUNY,0,PUBLIC,1,4-Year/Grad,261500,800000038227,SUNY COLLEGE OF AGRICULTURE AND TECHNOLOGY AT COBLESKILL,2309,2308,1,132,112,20,0,0,0,0,2309,132,718,24,2441,2353
2016,54,SCHOHARIE,0,SUNY,0,PUBLIC,1,4-Year/Grad,261500,800000038227,SUNY COLLEGE OF AGRICULTURE AND TECHNOLOGY AT COBLESKILL,2173,2167,6,634,104,530,0,0,0,0,2173,634,643,13,2807,2384.33
2017,54,SCHOHARIE,0,SUNY,0,PUBLIC,1,4-Year/Grad,261500,800000038227,SUNY COLLEGE OF AGRICULTURE AND TECHNOLOGY AT COBLESKILL,2195,2184,11,658,104,554,0,0,0,0,2195,658,701,15,2853,2414.33
2018,54,SCHOHARIE,0,SUNY,0,PUBLIC,1,4-Year/Grad,261500,800000038227,SUNY COLLEGE OF AGRICULTURE AND TECHNOLOGY AT COBLESKILL,2178,2176,2,155,108,47,0,0,0,0,2178,155,706,1,2333,2229.67
2019,54,SCHOHARIE,0,SUNY,0,PUBLIC,1,4-Year/Grad,261500,800000038227,SUNY COLLEGE OF AGRICULTURE AND TECHNOLOGY AT COBLESKILL,2085,2085,0,123,112,11,0,0,0,0,2085,123,608,6,2208,2126
2010,12,DELAWARE,0,SUNY,0,PUBLIC,1,4-Year/Grad,262000,800000053556,STATE UNIVERSITY OF NEW YORK COLLEGE OF TECHNOLOGY AT DELHI,2647,2647,0,590,337,253,0,0,0,0,2647,590,954,7,3237,2843.67
2011,12,DELAWARE,0,SUNY,0,PUBLIC,1,4-Year/Grad,262000,800000053556,STATE UNIVERSITY OF NEW YORK COLLEGE OF TECHNOLOGY AT DELHI,2607,2606,1,642,431,211,0,0,0,0,2607,642,884,1,3249,2821
2012,12,DELAWARE,0,SUNY,0,PUBLIC,1,4-Year/Grad,262000,800000053556,STATE UNIVERSITY OF NEW YORK COLLEGE OF TECHNOLOGY AT DELHI,2605,2605,0,546,511,35,0,0,0,0,2605,546,919,3,3151,2787
2013,12,DELAWARE,0,SUNY,0,PUBLIC,1,4-Year/Grad,262000,800000053556,STATE UNIVERSITY OF NEW YORK COLLEGE OF TECHNOLOGY AT DELHI,2590,2590,0,718,616,102,0,0,0,0,2590,718,918,3,3308,2829.33
2014,12,DELAWARE,0,SUNY,0,PUBLIC,1,4-Year/Grad,262000,800000053556,STATE UNIVERSITY OF NEW YORK COLLEGE OF TECHNOLOGY AT DELHI,2654,2654,0,942,753,189,0,0,0,2,2654,944,958,7,3598,2968.8
2015,12,DELAWARE,0,SUNY,0,PUBLIC,1,4-Year/Grad,262000,800000053556,STATE UNIVERSITY OF NEW YORK COLLEGE OF TECHNOLOGY AT DELHI,2460,2460,0,971,774,197,0,0,1,20,2461,991,811,7,3452,2792.67
2016,12,DELAWARE,0,SUNY,0,PUBLIC,1,4-Year/Grad,262000,800000053556,STATE UNIVERSITY OF NEW YORK COLLEGE OF TECHNOLOGY AT DELHI,2517,2517,0,828,609,219,0,0,7,28,2524,856,869,8,3380,2811.2
2017,12,DELAWARE,0,SUNY,0,PUBLIC,1,4-Year/Grad,262000,800000053556,STATE UNIVERSITY OF NEW YORK COLLEGE OF TECHNOLOGY AT DELHI,2607,2607,0,931,675,256,0,0,6,40,2613,971,958,4,3584,2939.33
2018,12,DELAWARE,0,SUNY,0,PUBLIC,1,4-Year/Grad,262000,800000053556,STATE UNIVERSITY OF NEW YORK COLLEGE OF TECHNOLOGY AT DELHI,2360,2360,0,591,555,36,0,0,8,54,2368,645,788,1,3013,2586.6
2019,12,DELAWARE,0,SUNY,0,PUBLIC,1,4-Year/Grad,262000,800000053556,STATE UNIVERSITY OF NEW YORK COLLEGE OF TECHNOLOGY AT DELHI,2342,2342,0,756,530,226,0,0,10,77,2352,833,783,1,3185,2634.8
2016,53,SCHENECTADY,0,SUNY,0,PUBLIC,1,4-Year/Grad,262010,800000064833,SUNY COLL OF AG & TECH AT DELHI - SCCC,57,57,0,72,72,0,0,0,0,0,57,72,0,0,129,81
2017,53,SCHENECTADY,0,SUNY,0,PUBLIC,1,4-Year/Grad,262010,800000064833,SUNY COLL OF AG & TECH AT DELHI - SCCC,97,97,0,52,52,0,0,0,0,0,97,52,0,0,149,114.33
2018,53,SCHENECTADY,0,SUNY,0,PUBLIC,1,4-Year/Grad,262010,800000064833,SUNY COLL OF AG & TECH AT DELHI - SCCC,154,154,0,73,73,0,0,0,0,0,154,73,0,0,227,178.33
2019,53,SCHENECTADY,0,SUNY,0,PUBLIC,1,4-Year/Grad,262010,800000064833,SUNY COLL OF AG & TECH AT DELHI - SCCC,49,49,0,46,46,0,0,0,0,0,49,46,0,0,95,64.33
2010,58,SUFFOLK,0,SUNY,0,PUBLIC,1,4-Year/Grad,262500,800000048733,SUNY COLLEGE OF TECHNOLOGY AT FARMINGDALE,5118,4960,158,1740,1278,462,0,0,0,0,5118,1740,943,159,6858,5698
2011,58,SUFFOLK,0,SUNY,0,PUBLIC,1,4-Year/Grad,262500,800000048733,SUNY COLLEGE OF TECHNOLOGY AT FARMINGDALE,5377,5208,169,2256,1545,711,0,0,0,0,5377,2256,966,238,7633,6129
2012,58,SUFFOLK,0,SUNY,0,PUBLIC,1,4-Year/Grad,262500,800000048733,SUNY COLLEGE OF TECHNOLOGY AT FARMINGDALE,5787,5657,130,2102,1600,502,0,0,0,0,5787,2102,1179,75,7889,6487.67
2013,58,SUFFOLK,0,SUNY,0,PUBLIC,1,4-Year/Grad,262500,800000048733,SUNY COLLEGE OF TECHNOLOGY AT FARMINGDALE,6074,5910,164,2088,1545,543,0,0,0,0,6074,2088,1121,25,8162,6770
2014,58,SUFFOLK,0,SUNY,0,PUBLIC,1,4-Year/Grad,262500,800000048733,SUNY COLLEGE OF TECHNOLOGY AT FARMINGDALE,6287,6152,135,2107,1616,491,0,0,0,0,6287,2107,1061,40,8394,6989.33
2015,58,SUFFOLK,0,SUNY,0,PUBLIC,1,4-Year/Grad,262500,800000048733,SUNY COLLEGE OF TECHNOLOGY AT FARMINGDALE,6388,6246,142,2260,1731,529,0,0,0,0,6388,2260,1012,47,8648,7141.33
2016,58,SUFFOLK,0,SUNY,0,PUBLIC,1,4-Year/Grad,262500,800000048733,SUNY COLLEGE OF TECHNOLOGY AT FARMINGDALE,6942,6820,122,2293,1771,522,0,0,0,0,6942,2293,1272,57,9235,7706.33
2017,58,SUFFOLK,0,SUNY,0,PUBLIC,1,4-Year/Grad,262500,800000048733,SUNY COLLEGE OF TECHNOLOGY AT FARMINGDALE,7407,7315,92,2145,1690,455,0,0,10,12,7417,2157,1281,44,9574,8136.8
2018,58,SUFFOLK,0,SUNY,0,PUBLIC,1,4-Year/Grad,262500,800000048733,SUNY COLLEGE OF TECHNOLOGY AT FARMINGDALE,7689,7575,114,2227,1819,408,0,0,27,27,7716,2254,1364,39,9970,8469.13
2019,58,SUFFOLK,0,SUNY,0,PUBLIC,1,4-Year/Grad,262500,800000048733,SUNY COLLEGE OF TECHNOLOGY AT FARMINGDALE,7785,7666,119,2154,1734,420,0,0,21,36,7806,2190,1495,51,9996,8538.4
2010,25,MADISON,0,SUNY,0,PUBLIC,1,4-Year/Grad,263000,800000050928,SUNY COLLEGE OF  AGRICULTURE AND TECHNOLOGY AT MORRISVILLE,3039,3037,2,415,268,147,0,0,0,0,3039,415,1102,115,3454,3177.33
2011,25,MADISON,0,SUNY,0,PUBLIC,1,4-Year/Grad,263000,800000050928,SUNY COLLEGE OF  AGRICULTURE AND TECHNOLOGY AT MORRISVILLE,2861,2860,1,369,230,139,0,0,0,0,2861,369,1004,70,3230,2984
2012,25,MADISON,0,SUNY,0,PUBLIC,1,4-Year/Grad,263000,800000050928,SUNY COLLEGE OF  AGRICULTURE AND TECHNOLOGY AT MORRISVILLE,2708,2708,0,387,196,191,0,0,0,0,2708,387,885,20,3095,2837
2013,25,MADISON,0,SUNY,0,PUBLIC,1,4-Year/Grad,263000,800000050928,SUNY COLLEGE OF  AGRICULTURE AND TECHNOLOGY AT MORRISVILLE,2668,2667,1,360,182,178,0,0,0,0,2668,360,841,10,3028,2788
2014,25,MADISON,0,SUNY,0,PUBLIC,1,4-Year/Grad,263000,800000050928,SUNY COLLEGE OF  AGRICULTURE AND TECHNOLOGY AT MORRISVILLE,2348,2347,1,319,153,166,0,0,0,0,2348,319,738,5,2667,2454.33
2015,25,MADISON,0,SUNY,0,PUBLIC,1,4-Year/Grad,263000,800000050928,SUNY COLLEGE OF  AGRICULTURE AND TECHNOLOGY AT MORRISVILLE,2531,2490,41,409,204,205,0,0,0,0,2531,409,812,18,2940,2667.33
2016,25,MADISON,0,SUNY,0,PUBLIC,1,4-Year/Grad,263000,800000050928,SUNY COLLEGE OF  AGRICULTURE AND TECHNOLOGY AT MORRISVILLE,2461,2424,37,289,134,155,0,0,0,0,2461,289,876,82,2750,2557.33
2017,25,MADISON,0,SUNY,0,PUBLIC,1,4-Year/Grad,263000,800000050928,SUNY COLLEGE OF  AGRICULTURE AND TECHNOLOGY AT MORRISVILLE,2414,2377,37,347,191,156,0,0,0,0,2414,347,875,85,2761,2529.67
2018,25,MADISON,0,SUNY,0,PUBLIC,1,4-Year/Grad,263000,800000050928,SUNY COLLEGE OF  AGRICULTURE AND TECHNOLOGY AT MORRISVILLE,2367,2317,50,417,222,195,0,0,0,0,2367,417,823,118,2784,2506
2019,25,MADISON,0,SUNY,0,PUBLIC,1,4-Year/Grad,263000,800000050928,SUNY COLLEGE OF  AGRICULTURE AND TECHNOLOGY AT MORRISVILLE,2154,2154,0,428,231,197,0,0,0,0,2154,428,745,125,2582,2296.67
2016,08,CHENANGO,0,SUNY,0,PUBLIC,1,4-Year/Grad,263010,800000053977,SUNY COLLEGE OF AGRICULTURE AND TECHNOLOGY AT MORRISVILLE - NORWICH CAMPUS,163,163,0,90,44,46,0,0,0,0,163,90,65,34,253,193
2017,08,CHENANGO,0,SUNY,0,PUBLIC,1,4-Year/Grad,263010,800000053977,SUNY COLLEGE OF AGRICULTURE AND TECHNOLOGY AT MORRISVILLE - NORWICH CAMPUS,200,200,0,102,47,55,0,0,0,0,200,102,41,32,302,234
2018,08,CHENANGO,0,SUNY,0,PUBLIC,1,4-Year/Grad,263010,800000053977,SUNY COLLEGE OF AGRICULTURE AND TECHNOLOGY AT MORRISVILLE - NORWICH CAMPUS,142,142,0,153,77,76,0,0,0,0,142,153,30,12,295,193
2019,08,CHENANGO,0,SUNY,0,PUBLIC,1,4-Year/Grad,263010,800000053977,SUNY COLLEGE OF AGRICULTURE AND TECHNOLOGY AT MORRISVILLE - NORWICH CAMPUS,129,129,0,147,90,57,0,0,0,0,129,147,28,11,276,178
2010,63,WARREN,0,SUNY,0,PUBLIC,0,2-Year,270300,800000036039,ADIRONDACK COMMUNITY COLLEGE,2423,2390,33,1713,1057,656,0,0,0,0,2423,1713,800,177,4136,2994
2011,63,WARREN,0,SUNY,0,PUBLIC,0,2-Year,270300,800000036039,ADIRONDACK COMMUNITY COLLEGE,2344,2311,33,1754,1078,676,0,0,0,0,2344,1754,616,103,4098,2928.67
2012,63,WARREN,0,SUNY,0,PUBLIC,0,2-Year,270300,800000036039,ADIRONDACK COMMUNITY COLLEGE,2263,2236,27,1724,1090,634,0,0,0,0,2263,1724,742,137,3987,2837.67
2013,63,WARREN,0,SUNY,0,PUBLIC,0,2-Year,270300,800000036039,ADIRONDACK COMMUNITY COLLEGE,2588,2573,15,1642,1041,601,0,0,0,0,2588,1642,990,106,4230,3135.33
2014,63,WARREN,0,SUNY,0,PUBLIC,0,2-Year,270300,800000036039,ADIRONDACK COMMUNITY COLLEGE,2522,2500,22,1725,1035,690,0,0,0,0,2522,1725,886,112,4247,3097
2015,63,WARREN,0,SUNY,0,PUBLIC,0,2-Year,270300,800000036039,ADIRONDACK COMMUNITY COLLEGE,2294,2277,17,1699,1024,675,0,0,0,0,2294,1699,843,92,3993,2860.33
2016,63,WARREN,0,SUNY,0,PUBLIC,0,2-Year,270300,800000036039,ADIRONDACK COMMUNITY COLLEGE,2179,2161,18,1755,934,821,0,0,0,0,2179,1755,793,96,3934,2764
2017,63,WARREN,0,SUNY,0,PUBLIC,0,2-Year,270300,800000036039,ADIRONDACK COMMUNITY COLLEGE,2190,2174,16,1774,858,916,0,0,0,0,2190,1774,851,83,3964,2781.33
2018,63,WARREN,0,SUNY,0,PUBLIC,0,2-Year,270300,800000036039,ADIRONDACK COMMUNITY COLLEGE,2090,2055,35,1638,835,803,0,0,0,0,2090,1638,784,72,3728,2636
2019,63,WARREN,0,SUNY,0,PUBLIC,0,2-Year,270300,800000036039,ADIRONDACK COMMUNITY COLLEGE,1905,1877,28,1515,768,747,0,0,0,0,1905,1515,762,71,3420,2410
2010,03,BROOME,0,SUNY,0,PUBLIC,0,2-Year,270600,800000055038,BROOME COMMUNITY COLLEGE,4559,4432,127,1618,1240,378,0,0,0,0,4559,1618,1549,116,6177,5098.33
2011,03,BROOME,0,SUNY,0,PUBLIC,0,2-Year,270600,800000055038,BROOME COMMUNITY COLLEGE,4376,4300,76,1824,1328,496,0,0,0,0,4376,1824,1491,108,6200,4984
2012,03,BROOME,0,SUNY,0,PUBLIC,0,2-Year,270600,800000055038,BROOME COMMUNITY COLLEGE,4113,4045,68,1839,1430,409,0,0,0,0,4113,1839,1359,120,5952,4726
2013,03,BROOME,0,SUNY,0,PUBLIC,0,2-Year,270600,800000055038,BROOME COMMUNITY COLLEGE,4192,4131,61,1702,1294,408,0,0,0,0,4192,1702,1433,107,5894,4759.33
2014,03,BROOME,0,SUNY,0,PUBLIC,0,2-Year,270600,800000055038,BROOME COMMUNITY COLLEGE,4337,4291,46,1607,1265,342,0,0,0,0,4337,1607,1738,104,5944,4872.67
2015,03,BROOME,0,SUNY,0,PUBLIC,0,2-Year,270600,800000055038,BROOME COMMUNITY COLLEGE,4265,4211,54,1661,1290,371,0,0,0,0,4265,1661,1564,267,5926,4818.67
2016,03,BROOME,0,SUNY,0,PUBLIC,0,2-Year,270600,800000055038,BROOME COMMUNITY COLLEGE,4157,4117,40,1545,1218,327,0,0,0,0,4157,1545,1726,262,5702,4672
2017,03,BROOME,0,SUNY,0,PUBLIC,0,2-Year,270600,800000055038,BROOME COMMUNITY COLLEGE,4075,4032,43,1549,1196,353,0,0,0,0,4075,1549,1684,258,5624,4591.33
2018,03,BROOME,0,SUNY,0,PUBLIC,0,2-Year,270600,800000055038,BROOME COMMUNITY COLLEGE,3771,3687,84,2736,1224,1512,0,0,0,0,3771,2736,1559,308,6507,4683
2019,03,BROOME,0,SUNY,0,PUBLIC,0,2-Year,270600,800000055038,BROOME COMMUNITY COLLEGE,3448,3359,89,2661,1099,1562,0,0,0,0,3448,2661,1404,228,6109,4335
2010,05,CAYUGA,0,SUNY,0,PUBLIC,0,2-Year,270900,800000054552,CAYUGA COUNTY COMMUNITY COLLEGE,2625,2598,27,2094,751,1343,0,0,0,0,2625,2094,708,128,4719,3323
2011,05,CAYUGA,0,SUNY,0,PUBLIC,0,2-Year,270900,800000054552,CAYUGA COUNTY COMMUNITY COLLEGE,2378,2357,21,2054,815,1239,0,0,0,0,2378,2054,655,114,4432,3062.67
2012,05,CAYUGA,0,SUNY,0,PUBLIC,0,2-Year,270900,800000054552,CAYUGA COUNTY COMMUNITY COLLEGE,2241,2229,12,2073,759,1314,0,0,0,0,2241,2073,652,138,4314,2932
2013,05,CAYUGA,0,SUNY,0,PUBLIC,0,2-Year,270900,800000054552,CAYUGA COUNTY COMMUNITY COLLEGE,2235,2223,12,2175,759,1416,0,0,0,0,2235,2175,616,108,4410,2960
2014,05,CAYUGA,0,SUNY,0,PUBLIC,0,2-Year,270900,800000054552,CAYUGA COUNTY COMMUNITY COLLEGE,1976,1964,12,2235,680,1555,0,0,0,0,1976,2235,585,86,4211,2721
2015,05,CAYUGA,0,SUNY,0,PUBLIC,0,2-Year,270900,800000054552,CAYUGA COUNTY COMMUNITY COLLEGE,1799,1783,16,2385,671,1714,0,0,0,0,1799,2385,521,105,4184,2594
2016,05,CAYUGA,0,SUNY,0,PUBLIC,0,2-Year,270900,800000054552,CAYUGA COUNTY COMMUNITY COLLEGE,1561,1541,20,2634,655,1979,0,0,0,0,1561,2634,470,100,4195,2439
2017,05,CAYUGA,0,SUNY,0,PUBLIC,0,2-Year,270900,800000054552,CAYUGA COUNTY COMMUNITY COLLEGE,1546,1523,23,2154,560,1594,0,0,0,0,1546,2154,505,314,3700,2264
2018,05,CAYUGA,0,SUNY,0,PUBLIC,0,2-Year,270900,800000054552,CAYUGA COUNTY COMMUNITY COLLEGE,1373,1364,9,2290,576,1714,0,0,0,0,1373,2290,449,89,3663,2136.33
2019,05,CAYUGA,0,SUNY,0,PUBLIC,0,2-Year,270900,800000054552,CAYUGA COUNTY COMMUNITY COLLEGE,943,907,36,2150,480,1670,0,0,0,0,943,2150,367,99,3093,1659.67
2016,46,OSWEGO,0,SUNY,0,PUBLIC,0,2-Year,270910,800000065326,CAYUGA COMMUNITY COLLEGE - FULTON CENTER,55,55,0,47,34,13,0,0,0,0,55,47,16,3,102,70.67
2017,46,OSWEGO,0,SUNY,0,PUBLIC,0,2-Year,270910,800000065326,CAYUGA COMMUNITY COLLEGE - FULTON CENTER,39,39,0,45,35,10,0,0,0,0,39,45,13,0,84,54
2018,46,OSWEGO,0,SUNY,0,PUBLIC,0,2-Year,270910,800000065326,CAYUGA COMMUNITY COLLEGE - FULTON CENTER,47,47,0,65,52,13,0,0,0,0,47,65,6,4,112,68.67
2019,46,OSWEGO,0,SUNY,0,PUBLIC,0,2-Year,270910,800000065326,CAYUGA COMMUNITY COLLEGE - FULTON CENTER,425,424,1,151,128,23,0,0,0,0,425,151,156,24,576,475.33
2010,09,CLINTON,0,SUNY,0,PUBLIC,0,2-Year,271200,800000053812,CLINTON COMMUNITY COLLEGE,1411,1291,120,941,355,586,0,0,0,0,1411,941,523,57,2352,1724.67
2011,09,CLINTON,0,SUNY,0,PUBLIC,0,2-Year,271200,800000053812,CLINTON COMMUNITY COLLEGE,1361,1277,84,973,344,629,0,0,0,0,1361,973,541,64,2334,1685.33
2012,09,CLINTON,0,SUNY,0,PUBLIC,0,2-Year,271200,800000053812,CLINTON COMMUNITY COLLEGE,1267,1182,85,982,339,643,0,0,0,0,1267,982,474,62,2249,1594.33
2013,09,CLINTON,0,SUNY,0,PUBLIC,0,2-Year,271200,800000053812,CLINTON COMMUNITY COLLEGE,1072,963,109,898,332,566,0,0,0,0,1072,898,397,48,1970,1371.33
2014,09,CLINTON,0,SUNY,0,PUBLIC,0,2-Year,271200,800000053812,CLINTON COMMUNITY COLLEGE,990,911,79,880,309,571,0,0,0,0,990,880,382,56,1870,1283.33
2015,09,CLINTON,0,SUNY,0,PUBLIC,0,2-Year,271200,800000053812,CLINTON COMMUNITY COLLEGE,907,802,105,907,319,588,0,0,0,0,907,907,337,28,1814,1209.33
2016,09,CLINTON,0,SUNY,0,PUBLIC,0,2-Year,271200,800000053812,CLINTON COMMUNITY COLLEGE,770,687,83,822,275,547,0,0,0,0,770,822,280,69,1592,1044
2017,09,CLINTON,0,SUNY,0,PUBLIC,0,2-Year,271200,800000053812,CLINTON COMMUNITY COLLEGE,680,629,51,867,288,579,0,0,0,0,680,867,266,23,1547,969
2018,09,CLINTON,0,SUNY,0,PUBLIC,0,2-Year,271200,800000053812,CLINTON COMMUNITY COLLEGE,605,550,55,771,257,514,0,0,0,0,605,771,212,47,1376,862
2019,09,CLINTON,0,SUNY,0,PUBLIC,0,2-Year,271200,800000053812,CLINTON COMMUNITY COLLEGE,529,496,33,770,239,531,0,0,0,0,529,770,182,35,1299,785.67
2010,10,COLUMBIA,0,SUNY,0,PUBLIC,0,2-Year,271500,800000053700,COLUMBIA-GREENE COMMUNITY COLLEGE,1110,1108,2,921,541,380,0,0,0,0,1110,921,360,76,2031,1417
2011,10,COLUMBIA,0,SUNY,0,PUBLIC,0,2-Year,271500,800000053700,COLUMBIA-GREENE COMMUNITY COLLEGE,1041,1037,4,1061,543,518,0,0,0,0,1041,1061,342,67,2102,1394.67
2012,10,COLUMBIA,0,SUNY,0,PUBLIC,0,2-Year,271500,800000053700,COLUMBIA-GREENE COMMUNITY COLLEGE,1023,1021,2,1103,574,529,0,0,0,0,1023,1103,348,74,2126,1390.67
2013,10,COLUMBIA,0,SUNY,0,PUBLIC,0,2-Year,271500,800000053700,COLUMBIA-GREENE COMMUNITY COLLEGE,964,963,1,1154,586,568,0,0,0,0,964,1154,339,84,2118,1348.67
2014,10,COLUMBIA,0,SUNY,0,PUBLIC,0,2-Year,271500,800000053700,COLUMBIA-GREENE COMMUNITY COLLEGE,852,845,7,1191,611,580,0,0,0,0,852,1191,288,63,2043,1249
2015,10,COLUMBIA,0,SUNY,0,PUBLIC,0,2-Year,271500,800000053700,COLUMBIA-GREENE COMMUNITY COLLEGE,711,710,1,1066,551,515,0,0,0,0,711,1066,264,53,1777,1066.33
2016,10,COLUMBIA,0,SUNY,0,PUBLIC,0,2-Year,271500,800000053700,COLUMBIA-GREENE COMMUNITY COLLEGE,678,672,6,967,512,455,0,0,0,0,678,967,269,56,1645,1000.33
2017,10,COLUMBIA,0,SUNY,0,PUBLIC,0,2-Year,271500,800000053700,COLUMBIA-GREENE COMMUNITY COLLEGE,596,595,1,1024,491,533,0,0,0,0,596,1024,228,68,1620,937.33
2018,10,COLUMBIA,0,SUNY,0,PUBLIC,0,2-Year,271500,800000053700,COLUMBIA-GREENE COMMUNITY COLLEGE,622,622,0,962,489,473,0,0,0,0,622,962,230,99,1584,942.67
2019,10,COLUMBIA,0,SUNY,0,PUBLIC,0,2-Year,271500,800000053700,COLUMBIA-GREENE COMMUNITY COLLEGE,528,527,1,933,444,489,0,0,0,0,528,933,208,62,1461,839
2010,43,ONTARIO,0,SUNY,0,PUBLIC,0,2-Year,271800,800000040595,FINGER LAKES COMMUNITY COLLEGE,3901,3877,24,3034,989,2045,0,0,0,0,3901,3034,1487,360,6935,4912.33
2011,43,ONTARIO,0,SUNY,0,PUBLIC,0,2-Year,271800,800000040595,FINGER LAKES COMMUNITY COLLEGE,3819,3811,8,2992,1050,1942,0,0,0,0,3819,2992,1516,331,6811,4816.33
2012,43,ONTARIO,0,SUNY,0,PUBLIC,0,2-Year,271800,800000040595,FINGER LAKES COMMUNITY COLLEGE,3610,3589,21,2929,1051,1878,0,0,0,0,3610,2929,1328,367,6539,4586.33
2013,43,ONTARIO,0,SUNY,0,PUBLIC,0,2-Year,271800,800000040595,FINGER LAKES COMMUNITY COLLEGE,3404,3382,22,2985,1030,1955,0,0,0,0,3404,2985,1347,395,6389,4399
2014,43,ONTARIO,0,SUNY,0,PUBLIC,0,2-Year,271800,800000040595,FINGER LAKES COMMUNITY COLLEGE,3318,3256,62,3475,994,2481,0,0,0,0,3318,3475,1284,302,6793,4476.33
2015,43,ONTARIO,0,SUNY,0,PUBLIC,0,2-Year,271800,800000040595,FINGER LAKES COMMUNITY COLLEGE,3003,2942,61,3752,964,2788,0,0,0,0,3003,3752,1159,324,6755,4253.67
2016,43,ONTARIO,0,SUNY,0,PUBLIC,0,2-Year,271800,800000040595,FINGER LAKES COMMUNITY COLLEGE,2587,2540,47,3933,965,2968,0,0,0,0,2587,3933,956,263,6520,3898
2017,43,ONTARIO,0,SUNY,0,PUBLIC,0,2-Year,271800,800000040595,FINGER LAKES COMMUNITY COLLEGE,2554,2487,67,3799,930,2869,0,0,0,0,2554,3799,1077,228,6353,3820.33
2018,43,ONTARIO,0,SUNY,0,PUBLIC,0,2-Year,271800,800000040595,FINGER LAKES COMMUNITY COLLEGE,2377,2324,53,3567,822,2745,0,0,0,0,2377,3567,908,319,5944,3566
2019,43,ONTARIO,0,SUNY,0,PUBLIC,0,2-Year,271800,800000040595,FINGER LAKES COMMUNITY COLLEGE,2243,2175,68,3406,777,2629,0,0,0,0,2243,3406,949,318,5649,3378.33
2010,57,STEUBEN,0,SUNY,0,PUBLIC,0,2-Year,272100,800000037963,CORNING COMMUNITY COLLEGE,2708,2563,145,2686,1073,1613,0,0,0,0,2708,2686,813,113,5394,3603.33
2011,57,STEUBEN,0,SUNY,0,PUBLIC,0,2-Year,272100,800000037963,CORNING COMMUNITY COLLEGE,2468,2339,129,2833,1116,1717,0,0,0,0,2468,2833,785,137,5301,3412.33
2012,57,STEUBEN,0,SUNY,0,PUBLIC,0,2-Year,272100,800000037963,CORNING COMMUNITY COLLEGE,2294,2164,130,2672,1056,1616,0,0,0,0,2294,2672,813,135,4966,3184.67
2013,57,STEUBEN,0,SUNY,0,PUBLIC,0,2-Year,272100,800000037963,CORNING COMMUNITY COLLEGE,2375,2262,113,2554,967,1587,0,0,0,0,2375,2554,930,97,4929,3226.33
2014,57,STEUBEN,0,SUNY,0,PUBLIC,0,2-Year,272100,800000037963,CORNING COMMUNITY COLLEGE,2114,1943,171,2406,864,1542,0,0,0,0,2114,2406,707,86,4520,2916
2015,57,STEUBEN,0,SUNY,0,PUBLIC,0,2-Year,272100,800000037963,CORNING COMMUNITY COLLEGE,1929,1798,131,2043,760,1283,0,0,0,0,1929,2043,670,84,3972,2610
2016,57,STEUBEN,0,SUNY,0,PUBLIC,0,2-Year,272100,800000037963,CORNING COMMUNITY COLLEGE,1775,1637,138,2136,690,1446,0,0,0,0,1775,2136,645,81,3911,2487
2017,57,STEUBEN,0,SUNY,0,PUBLIC,0,2-Year,272100,800000037963,CORNING COMMUNITY COLLEGE,1837,1671,166,2368,697,1671,0,0,0,0,1837,2368,701,81,4205,2626.33
2018,57,STEUBEN,0,SUNY,0,PUBLIC,0,2-Year,272100,800000037963,CORNING COMMUNITY COLLEGE,1663,1506,157,1761,665,1096,0,0,0,0,1663,1761,618,74,3424,2250
2019,57,STEUBEN,0,SUNY,0,PUBLIC,0,2-Year,272100,800000037963,CORNING COMMUNITY COLLEGE,1601,1297,304,2637,664,1973,0,0,0,0,1601,2637,571,127,4238,2480
2010,13,DUTCHESS,0,SUNY,0,PUBLIC,0,2-Year,272400,800000053315,DUTCHESS COMMUNITY COLLEGE,5449,5366,83,4880,2492,2388,0,0,0,0,5449,4880,1984,565,10329,7075.67
2011,13,DUTCHESS,0,SUNY,0,PUBLIC,0,2-Year,272400,800000053315,DUTCHESS COMMUNITY COLLEGE,5095,5006,89,5221,2638,2583,0,0,0,0,5095,5221,1933,548,10316,6835.33
2012,13,DUTCHESS,0,SUNY,0,PUBLIC,0,2-Year,272400,800000053315,DUTCHESS COMMUNITY COLLEGE,5052,4987,65,5426,2584,2842,0,0,0,0,5052,5426,2046,415,10478,6860.67
2013,13,DUTCHESS,0,SUNY,0,PUBLIC,0,2-Year,272400,800000053315,DUTCHESS COMMUNITY COLLEGE,4892,4816,76,5349,2405,2944,0,0,0,0,4892,5349,1942,365,10241,6675
2014,13,DUTCHESS,0,SUNY,0,PUBLIC,0,2-Year,272400,800000053315,DUTCHESS COMMUNITY COLLEGE,4666,4605,61,5239,2280,2959,0,0,0,0,4666,5239,1839,358,9905,6412.33
2015,13,DUTCHESS,0,SUNY,0,PUBLIC,0,2-Year,272400,800000053315,DUTCHESS COMMUNITY COLLEGE,4284,4191,93,5262,2140,3122,0,0,0,0,4284,5262,1703,316,9546,6038
2016,13,DUTCHESS,0,SUNY,0,PUBLIC,0,2-Year,272400,800000053315,DUTCHESS COMMUNITY COLLEGE,4071,3980,91,5275,2137,3138,0,0,0,0,4071,5275,1591,359,9346,5829.33
2017,13,DUTCHESS,0,SUNY,0,PUBLIC,0,2-Year,272400,800000053315,DUTCHESS COMMUNITY COLLEGE,3839,3748,91,5222,1907,3315,0,0,0,0,3839,5222,1554,323,9061,5579.67
2018,13,DUTCHESS,0,SUNY,0,PUBLIC,0,2-Year,272400,800000053315,DUTCHESS COMMUNITY COLLEGE,3666,3538,128,4916,1686,3230,0,0,0,0,3666,4916,1455,327,8582,5304.67
2019,13,DUTCHESS,0,SUNY,0,PUBLIC,0,2-Year,272400,800000053315,DUTCHESS COMMUNITY COLLEGE,3514,3335,179,5177,1685,3492,0,0,0,0,3514,5177,1373,302,8691,5239.67
2010,14,ERIE,0,SUNY,0,PUBLIC,0,2-Year,272700,800000034162,ERIE COMMUNITY COLLEGE-NORTH CAMPUS,10297,10173,124,4787,2626,2161,0,0,0,0,10297,4787,2803,652,15084,11892.67
2011,14,ERIE,0,SUNY,0,PUBLIC,0,2-Year,272700,800000034162,ERIE COMMUNITY COLLEGE-NORTH CAMPUS,9356,9211,145,4820,2739,2081,0,0,0,0,9356,4820,2597,659,14176,10962.67
2012,14,ERIE,0,SUNY,0,PUBLIC,0,2-Year,272700,800000034162,ERIE COMMUNITY COLLEGE-NORTH CAMPUS,9193,9073,120,4797,2611,2186,0,0,0,0,9193,4797,2588,672,13990,10792
2013,14,ERIE,0,SUNY,0,PUBLIC,0,2-Year,272700,800000034162,ERIE COMMUNITY COLLEGE-NORTH CAMPUS,9039,8900,139,4610,2476,2134,0,0,0,0,9039,4610,2681,574,13649,10575.67
2014,14,ERIE,0,SUNY,0,PUBLIC,0,2-Year,272700,800000034162,ERIE COMMUNITY COLLEGE-NORTH CAMPUS,8424,8313,111,4309,2311,1998,0,0,0,0,8424,4309,2385,580,12733,9860.33
2015,14,ERIE,0,SUNY,0,PUBLIC,0,2-Year,272700,800000034162,ERIE COMMUNITY COLLEGE-NORTH CAMPUS,7931,7832,99,4091,2195,1896,0,0,0,0,7931,4091,2384,557,12022,9294.67
2016,14,ERIE,0,SUNY,0,PUBLIC,0,2-Year,272700,800000034162,ERIE COMMUNITY COLLEGE-NORTH CAMPUS,3519,3471,48,2334,1182,1152,0,0,0,0,3519,2334,983,183,5853,4297
2017,14,ERIE,0,SUNY,0,PUBLIC,0,2-Year,272700,800000034162,ERIE COMMUNITY COLLEGE-NORTH CAMPUS,3312,3290,22,2539,1189,1350,0,0,0,0,3312,2539,877,148,5851,4158.33
2018,14,ERIE,0,SUNY,0,PUBLIC,0,2-Year,272700,800000034162,ERIE COMMUNITY COLLEGE-NORTH CAMPUS,3129,3122,7,2462,1198,1264,0,0,0,0,3129,2462,862,167,5591,3949.67
2019,14,ERIE,0,SUNY,0,PUBLIC,0,2-Year,272700,800000034162,ERIE COMMUNITY COLLEGE-NORTH CAMPUS,2921,2899,22,2438,1121,1317,0,0,0,0,2921,2438,816,161,5359,3733.67
2016,14,ERIE,0,SUNY,0,PUBLIC,0,2-Year,272710,800000052556,ERIE COMMUNITY COLLEGE-CITY CAMPUS,1840,1803,37,584,447,137,0,0,0,0,1840,584,555,83,2424,2034.67
2017,14,ERIE,0,SUNY,0,PUBLIC,0,2-Year,272710,800000052556,ERIE COMMUNITY COLLEGE-CITY CAMPUS,1827,1789,38,590,469,121,0,0,0,0,1827,590,554,87,2417,2023.67
2018,14,ERIE,0,SUNY,0,PUBLIC,0,2-Year,272710,800000052556,ERIE COMMUNITY COLLEGE-CITY CAMPUS,1704,1668,36,570,457,113,0,0,0,0,1704,570,486,74,2274,1894
2019,14,ERIE,0,SUNY,0,PUBLIC,0,2-Year,272710,800000052556,ERIE COMMUNITY COLLEGE-CITY CAMPUS,1570,1529,41,612,502,110,0,0,0,0,1570,612,437,80,2182,1774
2016,14,ERIE,0,SUNY,0,PUBLIC,0,2-Year,272720,800000052028,ERIE COMMUNITY COLLEGE-SOUTH CAMPUS,2131,2109,22,870,467,403,0,0,0,0,2131,870,641,179,3001,2421
2017,14,ERIE,0,SUNY,0,PUBLIC,0,2-Year,272720,800000052028,ERIE COMMUNITY COLLEGE-SOUTH CAMPUS,2122,2108,14,838,475,363,0,0,0,0,2122,838,627,126,2960,2401.33
2018,14,ERIE,0,SUNY,0,PUBLIC,0,2-Year,272720,800000052028,ERIE COMMUNITY COLLEGE-SOUTH CAMPUS,1873,1866,7,791,462,329,0,0,0,0,1873,791,523,146,2664,2136.67
2019,14,ERIE,0,SUNY,0,PUBLIC,0,2-Year,272720,800000052028,ERIE COMMUNITY COLLEGE-SOUTH CAMPUS,1761,1755,6,729,439,290,0,0,0,0,1761,729,521,132,2490,2004
2010,31,NEW YORK,0,SUNY,0,PUBLIC,0,2-Year,273000,800000047770,FASHION INSTITUTE OF TECHNOLOGY,7210,7066,144,2956,1011,1945,0,0,121,99,7331,3055,1061,260,10386,8355.93
2011,31,NEW YORK,0,SUNY,0,PUBLIC,0,2-Year,273000,800000047770,FASHION INSTITUTE OF TECHNOLOGY,7141,6989,152,2884,998,1886,0,0,111,89,7252,2973,1134,191,10225,8248.93
2012,31,NEW YORK,0,SUNY,0,PUBLIC,0,2-Year,273000,800000047770,FASHION INSTITUTE OF TECHNOLOGY,7154,7038,116,2694,974,1720,0,0,116,88,7270,2782,1227,192,10052,8203.2
2013,31,NEW YORK,0,SUNY,0,PUBLIC,0,2-Year,273000,800000047770,FASHION INSTITUTE OF TECHNOLOGY,7257,7173,84,2309,885,1424,0,0,120,69,7377,2378,1283,127,9755,8174.27
2014,31,NEW YORK,0,SUNY,0,PUBLIC,0,2-Year,273000,800000047770,FASHION INSTITUTE OF TECHNOLOGY,7454,7392,62,2113,868,1245,0,0,124,73,7578,2186,1312,196,9764,8311.53
2015,31,NEW YORK,0,SUNY,0,PUBLIC,0,2-Year,273000,800000047770,FASHION INSTITUTE OF TECHNOLOGY,7409,7346,63,1977,883,1094,0,0,116,63,7525,2040,1242,257,9565,8209.2
2016,31,NEW YORK,0,SUNY,0,PUBLIC,0,2-Year,273000,800000047770,FASHION INSTITUTE OF TECHNOLOGY,7395,7355,40,1690,813,877,0,0,120,56,7515,1746,1253,252,9261,8100.73
2017,31,NEW YORK,0,SUNY,0,PUBLIC,0,2-Year,273000,800000047770,FASHION INSTITUTE OF TECHNOLOGY,7210,7165,45,1451,759,692,0,0,131,55,7341,1506,1259,212,8847,7846.67
2018,31,NEW YORK,0,SUNY,0,PUBLIC,0,2-Year,273000,800000047770,FASHION INSTITUTE OF TECHNOLOGY,7246,7214,32,1309,724,585,0,0,160,52,7406,1361,1382,205,8767,7863.13
2019,31,NEW YORK,0,SUNY,0,PUBLIC,0,2-Year,273000,800000047770,FASHION INSTITUTE OF TECHNOLOGY,7340,7315,25,1168,725,443,0,0,165,53,7505,1221,1443,208,8726,7915.53
2010,27,MONTGOMERY,0,SUNY,0,PUBLIC,0,2-Year,273300,800000051653,FULTON-MONTGOMERY COMMUNITY COLLEGE,1863,1825,38,970,481,489,0,0,0,0,1863,970,690,59,2833,2186.33
2011,27,MONTGOMERY,0,SUNY,0,PUBLIC,0,2-Year,273300,800000051653,FULTON-MONTGOMERY COMMUNITY COLLEGE,1827,1819,8,1015,513,502,0,0,0,0,1827,1015,656,66,2842,2165.33
2012,27,MONTGOMERY,0,SUNY,0,PUBLIC,0,2-Year,273300,800000051653,FULTON-MONTGOMERY COMMUNITY COLLEGE,1719,1706,13,964,534,430,0,0,0,0,1719,964,744,120,2683,2040.33
2013,27,MONTGOMERY,0,SUNY,0,PUBLIC,0,2-Year,273300,800000051653,FULTON-MONTGOMERY COMMUNITY COLLEGE,1724,1689,35,1057,531,526,0,0,0,0,1724,1057,691,87,2781,2076.33
2014,27,MONTGOMERY,0,SUNY,0,PUBLIC,0,2-Year,273300,800000051653,FULTON-MONTGOMERY COMMUNITY COLLEGE,1523,1517,6,1066,491,575,0,0,0,0,1523,1066,528,85,2589,1878.33
2015,27,MONTGOMERY,0,SUNY,0,PUBLIC,0,2-Year,273300,800000051653,FULTON-MONTGOMERY COMMUNITY COLLEGE,1426,1394,32,1125,567,558,0,0,0,0,1426,1125,626,117,2551,1801
2016,27,MONTGOMERY,0,SUNY,0,PUBLIC,0,2-Year,273300,800000051653,FULTON-MONTGOMERY COMMUNITY COLLEGE,1349,1345,4,1285,583,702,0,0,0,0,1349,1285,551,107,2634,1777.33
2017,27,MONTGOMERY,0,SUNY,0,PUBLIC,0,2-Year,273300,800000051653,FULTON-MONTGOMERY COMMUNITY COLLEGE,1250,1244,6,1153,532,621,0,0,0,0,1250,1153,554,111,2403,1634.33
2018,27,MONTGOMERY,0,SUNY,0,PUBLIC,0,2-Year,273300,800000051653,FULTON-MONTGOMERY COMMUNITY COLLEGE,1139,1137,2,1312,510,802,0,0,0,0,1139,1312,517,163,2451,1576.33
2019,27,MONTGOMERY,0,SUNY,0,PUBLIC,0,2-Year,273300,800000051653,FULTON-MONTGOMERY COMMUNITY COLLEGE,995,991,4,1291,514,777,0,0,0,0,995,1291,485,168,2286,1425.33
2010,18,GENESEE,0,SUNY,0,PUBLIC,0,2-Year,273600,800000051573,GENESEE COMMUNITY COLLEGE,3692,3513,179,3794,1002,2792,0,0,0,0,3692,3794,1278,121,7486,4956.67
2011,18,GENESEE,0,SUNY,0,PUBLIC,0,2-Year,273600,800000051573,GENESEE COMMUNITY COLLEGE,3611,3447,164,3589,1068,2521,0,0,0,0,3611,3589,1190,114,7200,4807.33
2012,18,GENESEE,0,SUNY,0,PUBLIC,0,2-Year,273600,800000051573,GENESEE COMMUNITY COLLEGE,3469,3220,249,3496,1101,2395,0,0,0,0,3469,3496,1096,128,6965,4634.33
2013,18,GENESEE,0,SUNY,0,PUBLIC,0,2-Year,273600,800000051573,GENESEE COMMUNITY COLLEGE,3326,3102,224,3761,1088,2673,0,0,0,0,3326,3761,1071,97,7087,4579.67
2014,18,GENESEE,0,SUNY,0,PUBLIC,0,2-Year,273600,800000051573,GENESEE COMMUNITY COLLEGE,3178,2946,232,3705,1086,2619,0,0,0,0,3178,3705,1077,105,6883,4413
2015,18,GENESEE,0,SUNY,0,PUBLIC,0,2-Year,273600,800000051573,GENESEE COMMUNITY COLLEGE,2846,2658,188,3675,1057,2618,0,0,0,0,2846,3675,899,102,6521,4071
2016,18,GENESEE,0,SUNY,0,PUBLIC,0,2-Year,273600,800000051573,GENESEE COMMUNITY COLLEGE,2515,2313,202,3626,1061,2565,0,0,0,0,2515,3626,826,112,6141,3723.67
2017,18,GENESEE,0,SUNY,0,PUBLIC,0,2-Year,273600,800000051573,GENESEE COMMUNITY COLLEGE,2353,2166,187,3553,1022,2531,0,0,0,0,2353,3553,830,92,5906,3537.33
2018,18,GENESEE,0,SUNY,0,PUBLIC,0,2-Year,273600,800000051573,GENESEE COMMUNITY COLLEGE,2047,1843,204,3483,996,2487,0,0,0,0,2047,3483,627,100,5530,3208
2019,18,GENESEE,0,SUNY,0,PUBLIC,0,2-Year,273600,800000051573,GENESEE COMMUNITY COLLEGE,1918,1705,213,3367,925,2442,0,0,0,0,1918,3367,659,91,5285,3040.33
2010,21,HERKIMER,0,SUNY,0,PUBLIC,0,2-Year,273900,800000051369,HERKIMER COUNTY COMMUNITY COLLEGE,2582,2558,24,1192,451,741,0,0,0,0,2582,1192,1097,152,3774,2979.33
2011,21,HERKIMER,0,SUNY,0,PUBLIC,0,2-Year,273900,800000051369,HERKIMER COUNTY COMMUNITY COLLEGE,2470,2425,45,1209,449,760,0,0,0,0,2470,1209,972,142,3679,2873
2012,21,HERKIMER,0,SUNY,0,PUBLIC,0,2-Year,273900,800000051369,HERKIMER COUNTY COMMUNITY COLLEGE,2242,2207,35,1221,441,780,0,0,0,0,2242,1221,849,150,3463,2649
2013,21,HERKIMER,0,SUNY,0,PUBLIC,0,2-Year,273900,800000051369,HERKIMER COUNTY COMMUNITY COLLEGE,2081,2033,48,1134,406,728,0,0,0,0,2081,1134,693,133,3215,2459
2014,21,HERKIMER,0,SUNY,0,PUBLIC,0,2-Year,273900,800000051369,HERKIMER COUNTY COMMUNITY COLLEGE,1868,1859,9,1390,405,985,0,0,0,0,1868,1390,666,106,3258,2331.33
2015,21,HERKIMER,0,SUNY,0,PUBLIC,0,2-Year,273900,800000051369,HERKIMER COUNTY COMMUNITY COLLEGE,1752,1745,7,1268,381,887,0,0,0,0,1752,1268,759,130,3020,2174.67
2016,21,HERKIMER,0,SUNY,0,PUBLIC,0,2-Year,273900,800000051369,HERKIMER COUNTY COMMUNITY COLLEGE,1681,1677,4,966,310,656,0,0,0,0,1681,966,646,68,2647,2003
2017,21,HERKIMER,0,SUNY,0,PUBLIC,0,2-Year,273900,800000051369,HERKIMER COUNTY COMMUNITY COLLEGE,1636,1628,8,996,331,665,0,0,0,0,1636,996,604,67,2632,1968
2018,21,HERKIMER,0,SUNY,0,PUBLIC,0,2-Year,273900,800000051369,HERKIMER COUNTY COMMUNITY COLLEGE,1396,1391,5,1002,313,689,0,0,0,0,1396,1002,437,84,2398,1730
2019,21,HERKIMER,0,SUNY,0,PUBLIC,0,2-Year,273900,800000051369,HERKIMER COUNTY COMMUNITY COLLEGE,1268,1263,5,1128,295,833,0,0,0,0,1268,1128,524,88,2396,1644
2010,49,RENSSELAER,0,SUNY,0,PUBLIC,0,2-Year,274200,800000039434,HUDSON VALLEY COMMUNITY COLLEGE,8059,7628,431,5739,2436,3303,0,0,0,0,8059,5739,2712,681,13798,9972
2011,49,RENSSELAER,0,SUNY,0,PUBLIC,0,2-Year,274200,800000039434,HUDSON VALLEY COMMUNITY COLLEGE,7643,7303,340,5951,2558,3393,0,0,0,0,7643,5951,2670,595,13594,9626.67
2012,49,RENSSELAER,0,SUNY,0,PUBLIC,0,2-Year,274200,800000039434,HUDSON VALLEY COMMUNITY COLLEGE,7175,6896,279,5939,2458,3481,0,0,0,0,7175,5939,2445,658,13114,9154.67
2013,49,RENSSELAER,0,SUNY,0,PUBLIC,0,2-Year,274200,800000039434,HUDSON VALLEY COMMUNITY COLLEGE,6832,6545,287,6009,2472,3537,0,0,0,0,6832,6009,2125,618,12841,8835
2014,49,RENSSELAER,0,SUNY,0,PUBLIC,0,2-Year,274200,800000039434,HUDSON VALLEY COMMUNITY COLLEGE,6422,6172,250,5755,2410,3345,0,0,0,0,6422,5755,2020,591,12177,8340.33
2015,49,RENSSELAER,0,SUNY,0,PUBLIC,0,2-Year,274200,800000039434,HUDSON VALLEY COMMUNITY COLLEGE,6253,5960,293,5543,2283,3260,0,0,0,0,6253,5543,2229,484,11796,8100.67
2016,49,RENSSELAER,0,SUNY,0,PUBLIC,0,2-Year,274200,800000039434,HUDSON VALLEY COMMUNITY COLLEGE,5880,5625,255,5707,2276,3431,0,0,0,0,5880,5707,2112,533,11587,7782.33
2017,49,RENSSELAER,0,SUNY,0,PUBLIC,0,2-Year,274200,800000039434,HUDSON VALLEY COMMUNITY COLLEGE,5802,5541,261,5218,2154,3064,0,0,0,0,5802,5218,2142,483,11020,7541.33
2018,49,RENSSELAER,0,SUNY,0,PUBLIC,0,2-Year,274200,800000039434,HUDSON VALLEY COMMUNITY COLLEGE,5636,5358,278,5260,2204,3056,0,0,0,0,5636,5260,2111,575,10896,7389.33
2019,49,RENSSELAER,0,SUNY,0,PUBLIC,0,2-Year,274200,800000039434,HUDSON VALLEY COMMUNITY COLLEGE,5401,5157,244,5015,2118,2897,0,0,0,0,5401,5015,2022,531,10416,7072.67
2010,06,CHAUTAUQUA,0,SUNY,0,PUBLIC,0,2-Year,274500,800000054194,JAMESTOWN COMMUNITY COLLEGE,3105,3071,34,2580,851,1729,0,0,0,0,3105,2580,1147,222,5685,3965
2011,06,CHAUTAUQUA,0,SUNY,0,PUBLIC,0,2-Year,274500,800000054194,JAMESTOWN COMMUNITY COLLEGE,2954,2895,59,2503,793,1710,0,0,0,0,2954,2503,1059,165,5457,3788.33
2012,06,CHAUTAUQUA,0,SUNY,0,PUBLIC,0,2-Year,274500,800000054194,JAMESTOWN COMMUNITY COLLEGE,2772,2709,63,2285,738,1547,0,0,0,0,2772,2285,991,123,5057,3533.67
2013,06,CHAUTAUQUA,0,SUNY,0,PUBLIC,0,2-Year,274500,800000054194,JAMESTOWN COMMUNITY COLLEGE,2764,2627,137,2414,754,1660,0,0,0,0,2764,2414,982,111,5178,3568.67
2014,06,CHAUTAUQUA,0,SUNY,0,PUBLIC,0,2-Year,274500,800000054194,JAMESTOWN COMMUNITY COLLEGE,2551,2472,79,2514,715,1799,0,0,0,0,2551,2514,966,101,5065,3389
2015,06,CHAUTAUQUA,0,SUNY,0,PUBLIC,0,2-Year,274500,800000054194,JAMESTOWN COMMUNITY COLLEGE,2353,2226,127,2473,664,1809,0,0,0,0,2353,2473,865,90,4826,3177.33
2016,06,CHAUTAUQUA,0,SUNY,0,PUBLIC,0,2-Year,274500,800000054194,JAMESTOWN COMMUNITY COLLEGE,1690,1611,79,1528,443,1085,0,0,0,0,1690,1528,599,58,3218,2199.33
2017,06,CHAUTAUQUA,0,SUNY,0,PUBLIC,0,2-Year,274500,800000054194,JAMESTOWN COMMUNITY COLLEGE,1630,1525,105,1505,402,1103,0,0,0,0,1630,1505,604,42,3135,2131.67
2018,06,CHAUTAUQUA,0,SUNY,0,PUBLIC,0,2-Year,274500,800000054194,JAMESTOWN COMMUNITY COLLEGE,1515,1413,102,1688,405,1283,0,0,0,0,1515,1688,551,53,3203,2077.67
2019,06,CHAUTAUQUA,0,SUNY,0,PUBLIC,0,2-Year,274500,800000054194,JAMESTOWN COMMUNITY COLLEGE,1545,1431,114,1494,361,1133,0,0,0,0,1545,1494,616,48,3039,2043
2016,04,CATTARAUGUS,0,SUNY,0,PUBLIC,0,2-Year,274510,800000054716,JAMESTOWN COMMUNITY COLLEGE CATTARAUGUS COUNTY CAMPUS,459,422,37,940,179,761,0,0,0,0,459,940,155,20,1399,772.33
2017,04,CATTARAUGUS,0,SUNY,0,PUBLIC,0,2-Year,274510,800000054716,JAMESTOWN COMMUNITY COLLEGE CATTARAUGUS COUNTY CAMPUS,430,370,60,898,195,703,0,0,0,0,430,898,149,26,1328,729.33
2018,04,CATTARAUGUS,0,SUNY,0,PUBLIC,0,2-Year,274510,800000054716,JAMESTOWN COMMUNITY COLLEGE CATTARAUGUS COUNTY CAMPUS,420,373,47,853,198,655,0,0,0,0,420,853,149,18,1273,704.33
2019,04,CATTARAUGUS,0,SUNY,0,PUBLIC,0,2-Year,274510,800000054716,JAMESTOWN COMMUNITY COLLEGE CATTARAUGUS COUNTY CAMPUS,428,381,47,983,187,796,0,0,0,0,428,983,143,21,1411,755.67
2010,22,JEFFERSON,0,SUNY,0,PUBLIC,0,2-Year,274800,800000051165,JEFFERSON COMMUNITY COLLEGE,2211,2172,39,1527,772,755,0,0,0,0,2211,1527,782,220,3738,2720
2011,22,JEFFERSON,0,SUNY,0,PUBLIC,0,2-Year,274800,800000051165,JEFFERSON COMMUNITY COLLEGE,2237,2218,19,1578,819,759,0,0,0,0,2237,1578,770,253,3815,2763
2012,22,JEFFERSON,0,SUNY,0,PUBLIC,0,2-Year,274800,800000051165,JEFFERSON COMMUNITY COLLEGE,2254,2232,22,1587,892,695,0,0,0,0,2254,1587,774,242,3841,2783
2013,22,JEFFERSON,0,SUNY,0,PUBLIC,0,2-Year,274800,800000051165,JEFFERSON COMMUNITY COLLEGE,2234,2216,18,1697,932,765,0,0,0,0,2234,1697,708,218,3931,2799.67
2014,22,JEFFERSON,0,SUNY,0,PUBLIC,0,2-Year,274800,800000051165,JEFFERSON COMMUNITY COLLEGE,2153,2132,21,1727,877,850,0,0,0,0,2153,1727,773,193,3880,2728.67
2015,22,JEFFERSON,0,SUNY,0,PUBLIC,0,2-Year,274800,800000051165,JEFFERSON COMMUNITY COLLEGE,2095,2056,39,1653,798,855,0,0,0,0,2095,1653,759,183,3748,2646
2016,22,JEFFERSON,0,SUNY,0,PUBLIC,0,2-Year,274800,800000051165,JEFFERSON COMMUNITY COLLEGE,2082,2045,37,1550,674,876,0,0,0,0,2082,1550,767,140,3632,2598.67
2017,22,JEFFERSON,0,SUNY,0,PUBLIC,0,2-Year,274800,800000051165,JEFFERSON COMMUNITY COLLEGE,1947,1928,19,1513,686,827,0,0,0,0,1947,1513,745,152,3460,2451.33
2018,22,JEFFERSON,0,SUNY,0,PUBLIC,0,2-Year,274800,800000051165,JEFFERSON COMMUNITY COLLEGE,1802,1781,21,1475,628,847,0,0,0,0,1802,1475,659,194,3277,2293.67
2019,22,JEFFERSON,0,SUNY,0,PUBLIC,0,2-Year,274800,800000051165,JEFFERSON COMMUNITY COLLEGE,1573,1543,30,1411,603,808,0,0,0,0,1573,1411,601,148,2984,2043.33
2010,41,ONEIDA,0,SUNY,0,PUBLIC,0,2-Year,275100,800000041234,MOHAWK VALLEY COMMUNITY COLLEGE,4761,4715,46,2394,1220,1174,0,0,0,0,4761,2394,1631,170,7155,5559
2011,41,ONEIDA,0,SUNY,0,PUBLIC,0,2-Year,275100,800000041234,MOHAWK VALLEY COMMUNITY COLLEGE,4904,4846,58,2739,1237,1502,0,0,0,0,4904,2739,1681,227,7643,5817
2012,41,ONEIDA,0,SUNY,0,PUBLIC,0,2-Year,275100,800000041234,MOHAWK VALLEY COMMUNITY COLLEGE,4601,4537,64,2850,1312,1538,0,0,0,0,4601,2850,1527,207,7451,5551
2013,41,ONEIDA,0,SUNY,0,PUBLIC,0,2-Year,275100,800000041234,MOHAWK VALLEY COMMUNITY COLLEGE,4616,4563,53,2817,1266,1551,0,0,0,0,4616,2817,1489,153,7433,5555
2014,41,ONEIDA,0,SUNY,0,PUBLIC,0,2-Year,275100,800000041234,MOHAWK VALLEY COMMUNITY COLLEGE,4024,3987,37,3125,1166,1959,0,0,0,0,4024,3125,1337,163,7149,5065.67
2015,41,ONEIDA,0,SUNY,0,PUBLIC,0,2-Year,275100,800000041234,MOHAWK VALLEY COMMUNITY COLLEGE,3632,3565,67,3043,1048,1995,0,0,0,0,3632,3043,1221,95,6675,4646.33
2016,41,ONEIDA,0,SUNY,0,PUBLIC,0,2-Year,275100,800000041234,MOHAWK VALLEY COMMUNITY COLLEGE,2932,2898,34,1979,789,1190,0,0,0,0,2932,1979,1035,140,4911,3591.67
2017,41,ONEIDA,0,SUNY,0,PUBLIC,0,2-Year,275100,800000041234,MOHAWK VALLEY COMMUNITY COLLEGE,2876,2846,30,2082,781,1301,0,0,0,0,2876,2082,1117,142,4958,3570
2018,41,ONEIDA,0,SUNY,0,PUBLIC,0,2-Year,275100,800000041234,MOHAWK VALLEY COMMUNITY COLLEGE,2742,2699,43,2057,768,1289,0,0,0,0,2742,2057,1008,88,4799,3427.67
2019,41,ONEIDA,0,SUNY,0,PUBLIC,0,2-Year,275100,800000041234,MOHAWK VALLEY COMMUNITY COLLEGE,2633,2582,51,2053,726,1327,0,0,0,0,2633,2053,1032,177,4686,3317.33
2016,41,ONEIDA,0,SUNY,0,PUBLIC,0,2-Year,275110,800000041333,MOHAWK VALLEY COMMUNITY COLLEGE-ROME CAMPUS,480,433,47,1234,178,1056,0,0,0,0,480,1234,126,17,1714,891.33
2017,41,ONEIDA,0,SUNY,0,PUBLIC,0,2-Year,275110,800000041333,MOHAWK VALLEY COMMUNITY COLLEGE-ROME CAMPUS,448,409,39,1100,135,965,0,0,0,0,448,1100,139,23,1548,814.67
2018,41,ONEIDA,0,SUNY,0,PUBLIC,0,2-Year,275110,800000041333,MOHAWK VALLEY COMMUNITY COLLEGE-ROME CAMPUS,419,367,52,1099,112,987,0,0,0,0,419,1099,142,16,1518,785.33
2019,41,ONEIDA,0,SUNY,0,PUBLIC,0,2-Year,275110,800000041333,MOHAWK VALLEY COMMUNITY COLLEGE-ROME CAMPUS,335,292,43,986,122,864,0,0,0,0,335,986,94,10,1321,663.67
2010,26,MONROE,0,SUNY,0,PUBLIC,0,2-Year,275400,800000034189,MONROE COMMUNITY COLLEGE,12152,12097,55,6843,5476,1367,0,0,0,0,12152,6843,4088,926,18995,14433
2011,26,MONROE,0,SUNY,0,PUBLIC,0,2-Year,275400,800000034189,MONROE COMMUNITY COLLEGE,10992,10972,20,11964,4996,6968,0,0,0,0,10992,11964,3699,890,22956,14980
2012,26,MONROE,0,SUNY,0,PUBLIC,0,2-Year,275400,800000034189,MONROE COMMUNITY COLLEGE,10554,10539,15,6742,5261,1481,0,0,0,0,10554,6742,3501,845,17296,12801.33
2013,26,MONROE,0,SUNY,0,PUBLIC,0,2-Year,275400,800000034189,MONROE COMMUNITY COLLEGE,10260,10254,6,6198,4800,1398,0,0,0,0,10260,6198,3354,773,16458,12326
2014,26,MONROE,0,SUNY,0,PUBLIC,0,2-Year,275400,800000034189,MONROE COMMUNITY COLLEGE,9374,9363,11,5961,4619,1342,0,0,0,0,9374,5961,2943,601,15335,11361
2015,26,MONROE,0,SUNY,0,PUBLIC,0,2-Year,275400,800000034189,MONROE COMMUNITY COLLEGE,8856,8848,8,5730,4537,1193,0,0,0,0,8856,5730,2896,482,14586,10766
2016,26,MONROE,0,SUNY,0,PUBLIC,0,2-Year,275400,800000034189,MONROE COMMUNITY COLLEGE,8214,8210,4,5373,4246,1127,0,0,0,0,8214,5373,2644,559,13587,10005
2017,26,MONROE,0,SUNY,0,PUBLIC,0,2-Year,275400,800000034189,MONROE COMMUNITY COLLEGE,7056,7054,2,4678,3614,1064,0,0,0,0,7056,4678,2267,435,11734,8615.33
2018,26,MONROE,0,SUNY,0,PUBLIC,0,2-Year,275400,800000034189,MONROE COMMUNITY COLLEGE,6593,6589,4,4374,3356,1018,0,0,0,0,6593,4374,2283,359,10967,8051
2019,26,MONROE,0,SUNY,0,PUBLIC,0,2-Year,275400,800000034189,MONROE COMMUNITY COLLEGE,6024,6019,5,4206,3303,903,0,0,0,0,6024,4206,1938,323,10230,7426
2017,26,MONROE,0,SUNY,0,PUBLIC,0,2-Year,275410,800000050484,MONROE COMMUNITY COLLEGE - DOWNTOWN CAMPUS,810,810,0,405,363,42,0,0,0,0,810,405,208,28,1215,945
2018,26,MONROE,0,SUNY,0,PUBLIC,0,2-Year,275410,800000050484,MONROE COMMUNITY COLLEGE - DOWNTOWN CAMPUS,890,890,0,416,416,0,0,0,0,0,890,416,225,46,1306,1028.67
2019,26,MONROE,0,SUNY,0,PUBLIC,0,2-Year,275410,800000050484,MONROE COMMUNITY COLLEGE - DOWNTOWN CAMPUS,903,903,0,439,439,0,0,0,0,0,903,439,240,27,1342,1049.33
2010,28,NASSAU,0,SUNY,0,PUBLIC,0,2-Year,275700,800000049411,NASSAU COMMUNITY COLLEGE,16199,15603,596,7568,6223,1345,0,0,0,0,16199,7568,4941,584,23767,18721.67
2011,28,NASSAU,0,SUNY,0,PUBLIC,0,2-Year,275700,800000049411,NASSAU COMMUNITY COLLEGE,14940,14422,518,8610,7366,1244,0,0,0,0,14940,8610,4328,676,23550,17810
2012,28,NASSAU,0,SUNY,0,PUBLIC,0,2-Year,275700,800000049411,NASSAU COMMUNITY COLLEGE,14560,14039,521,8780,7365,1415,0,0,0,0,14560,8780,4218,734,23340,17486.67
2013,28,NASSAU,0,SUNY,0,PUBLIC,0,2-Year,275700,800000049411,NASSAU COMMUNITY COLLEGE,14209,13588,621,9109,7463,1646,0,0,0,0,14209,9109,4134,631,23318,17245.33
2014,28,NASSAU,0,SUNY,0,PUBLIC,0,2-Year,275700,800000049411,NASSAU COMMUNITY COLLEGE,13541,12975,566,8833,7243,1590,0,0,0,0,13541,8833,4005,617,22374,16485.33
2015,28,NASSAU,0,SUNY,0,PUBLIC,0,2-Year,275700,800000049411,NASSAU COMMUNITY COLLEGE,12956,12425,531,8602,7076,1526,0,0,0,0,12956,8602,3915,1080,21558,15823.33
2016,28,NASSAU,0,SUNY,0,PUBLIC,0,2-Year,275700,800000049411,NASSAU COMMUNITY COLLEGE,11832,11257,575,8542,6947,1595,0,0,0,0,11832,8542,3550,620,20374,14679.33
2017,28,NASSAU,0,SUNY,0,PUBLIC,0,2-Year,275700,800000049411,NASSAU COMMUNITY COLLEGE,11258,10731,527,7801,6233,1568,0,0,0,0,11258,7801,3344,530,19059,13858.33
2018,28,NASSAU,0,SUNY,0,PUBLIC,0,2-Year,275700,800000049411,NASSAU COMMUNITY COLLEGE,10100,9573,527,7306,5749,1557,0,0,0,0,10100,7306,3138,492,17406,12535.33
2019,28,NASSAU,0,SUNY,0,PUBLIC,0,2-Year,275700,800000049411,NASSAU COMMUNITY COLLEGE,9486,9040,446,7164,5707,1457,0,0,0,0,9486,7164,3083,535,16650,11874
2010,40,NIAGARA,0,SUNY,0,PUBLIC,0,2-Year,276000,800000041726,NIAGARA COUNTY COMMUNITY COLLEGE,4710,4669,41,2718,1295,1423,0,0,0,0,4710,2718,1630,218,7428,5616
2011,40,NIAGARA,0,SUNY,0,PUBLIC,0,2-Year,276000,800000041726,NIAGARA COUNTY COMMUNITY COLLEGE,4387,4341,46,2770,1258,1512,0,0,0,0,4387,2770,1448,193,7157,5310.33
2012,40,NIAGARA,0,SUNY,0,PUBLIC,0,2-Year,276000,800000041726,NIAGARA COUNTY COMMUNITY COLLEGE,4207,4162,45,2528,1173,1355,0,0,0,0,4207,2528,1350,153,6735,5049.67
2013,40,NIAGARA,0,SUNY,0,PUBLIC,0,2-Year,276000,800000041726,NIAGARA COUNTY COMMUNITY COLLEGE,4178,4138,40,2452,1159,1293,0,0,0,0,4178,2452,1399,155,6630,4995.33
2014,40,NIAGARA,0,SUNY,0,PUBLIC,0,2-Year,276000,800000041726,NIAGARA COUNTY COMMUNITY COLLEGE,3994,3949,45,2484,1169,1315,0,0,0,0,3994,2484,1312,150,6478,4822
2015,40,NIAGARA,0,SUNY,0,PUBLIC,0,2-Year,276000,800000041726,NIAGARA COUNTY COMMUNITY COLLEGE,3610,3559,51,2506,1159,1347,0,0,0,0,3610,2506,1206,161,6116,4445.33
2016,40,NIAGARA,0,SUNY,0,PUBLIC,0,2-Year,276000,800000041726,NIAGARA COUNTY COMMUNITY COLLEGE,3418,3360,58,2475,1021,1454,0,0,0,0,3418,2475,1076,145,5893,4243
2017,40,NIAGARA,0,SUNY,0,PUBLIC,0,2-Year,276000,800000041726,NIAGARA COUNTY COMMUNITY COLLEGE,3229,3160,69,2210,913,1297,0,0,0,0,3229,2210,1032,107,5439,3965.67
2018,40,NIAGARA,0,SUNY,0,PUBLIC,0,2-Year,276000,800000041726,NIAGARA COUNTY COMMUNITY COLLEGE,2962,2917,45,2085,829,1256,0,0,0,0,2962,2085,946,114,5047,3657
2019,40,NIAGARA,0,SUNY,0,PUBLIC,0,2-Year,276000,800000041726,NIAGARA COUNTY COMMUNITY COLLEGE,2751,2696,55,2234,865,1369,0,0,0,0,2751,2234,962,115,4985,3495.67
2010,15,ESSEX,0,SUNY,0,PUBLIC,0,2-Year,276300,800000051760,NORTH COUNTRY COMMUNITY COLLEGE,1087,996,91,1155,146,1013,0,0,0,0,1087,1155,336,105,2242,1472
2011,15,ESSEX,0,SUNY,0,PUBLIC,0,2-Year,276300,800000051760,NORTH COUNTRY COMMUNITY COLLEGE,1124,1039,85,1330,186,1144,0,0,0,0,1124,1330,349,26,2454,1567.33
2012,15,ESSEX,0,SUNY,0,PUBLIC,0,2-Year,276300,800000051760,NORTH COUNTRY COMMUNITY COLLEGE,1023,649,374,1304,160,1144,0,0,0,0,1023,1304,308,27,2327,1457.67
2013,15,ESSEX,0,SUNY,0,PUBLIC,0,2-Year,276300,800000051760,NORTH COUNTRY COMMUNITY COLLEGE,951,870,81,1137,151,986,0,0,0,0,951,1137,360,36,2088,1330
2014,15,ESSEX,0,SUNY,0,PUBLIC,0,2-Year,276300,800000051760,NORTH COUNTRY COMMUNITY COLLEGE,957,884,73,1005,158,847,0,0,0,0,957,1005,398,49,1962,1292
2015,15,ESSEX,0,SUNY,0,PUBLIC,0,2-Year,276300,800000051760,NORTH COUNTRY COMMUNITY COLLEGE,816,751,65,1067,154,913,0,0,0,0,816,1067,273,18,1883,1171.67
2016,15,ESSEX,0,SUNY,0,PUBLIC,0,2-Year,276300,800000051760,NORTH COUNTRY COMMUNITY COLLEGE,1612,1432,180,2250,316,1934,0,0,0,0,1612,2250,532,22,3862,2362
2017,15,ESSEX,0,SUNY,0,PUBLIC,0,2-Year,276300,800000051760,NORTH COUNTRY COMMUNITY COLLEGE,614,552,62,1036,87,949,0,0,0,0,614,1036,178,9,1650,959.33
2017,16,FRANKLIN,0,SUNY,0,PUBLIC,0,2-Year,276320,800000051752,NORTH COUNTRY COMMUNITY COLLEGE-MALONE CAMPUS,208,208,0,47,47,0,0,0,0,0,208,47,72,6,255,223.67
2017,15,ESSEX,0,SUNY,0,PUBLIC,0,2-Year,276330,800000051830,NORTH COUNTRY COMMUNITY COLLEGE-TICONDEROGA CAMPUS,74,74,0,27,27,0,0,0,0,0,74,27,18,4,101,83
2010,42,ONONDAGA,0,SUNY,0,PUBLIC,0,2-Year,276600,800000040739,ONONDAGA COMMUNITY COLLEGE,6894,6701,193,4891,2027,2864,0,0,0,0,6894,4891,2309,1019,11785,8524.33
2011,42,ONONDAGA,0,SUNY,0,PUBLIC,0,2-Year,276600,800000040739,ONONDAGA COMMUNITY COLLEGE,6818,6648,170,5927,2096,3831,0,0,0,0,6818,5927,2320,1043,12745,8793.67
2012,42,ONONDAGA,0,SUNY,0,PUBLIC,0,2-Year,276600,800000040739,ONONDAGA COMMUNITY COLLEGE,6719,6576,143,6299,2308,3991,0,0,0,0,6719,6299,2231,812,13018,8818.67
2013,42,ONONDAGA,0,SUNY,0,PUBLIC,0,2-Year,276600,800000040739,ONONDAGA COMMUNITY COLLEGE,6540,6416,124,6293,2248,4045,0,0,0,0,6540,6293,2264,715,12833,8637.67
2014,42,ONONDAGA,0,SUNY,0,PUBLIC,0,2-Year,276600,800000040739,ONONDAGA COMMUNITY COLLEGE,6344,6246,98,5927,2144,3783,0,0,0,0,6344,5927,2239,730,12271,8319.67
2015,42,ONONDAGA,0,SUNY,0,PUBLIC,0,2-Year,276600,800000040739,ONONDAGA COMMUNITY COLLEGE,5895,5769,126,5991,2240,3751,0,0,0,0,5895,5991,2046,499,11886,7892
2016,42,ONONDAGA,0,SUNY,0,PUBLIC,0,2-Year,276600,800000040739,ONONDAGA COMMUNITY COLLEGE,5736,5575,161,6904,2241,4663,0,0,0,0,5736,6904,2003,539,12640,8037.33
2017,42,ONONDAGA,0,SUNY,0,PUBLIC,0,2-Year,276600,800000040739,ONONDAGA COMMUNITY COLLEGE,5118,5008,110,5541,2047,3494,0,0,0,0,5118,5541,1870,486,10659,6965
2018,42,ONONDAGA,0,SUNY,0,PUBLIC,0,2-Year,276600,800000040739,ONONDAGA COMMUNITY COLLEGE,4725,4621,104,5109,1569,3540,0,0,0,0,4725,5109,1739,490,9834,6428
2019,42,ONONDAGA,0,SUNY,0,PUBLIC,0,2-Year,276600,800000040739,ONONDAGA COMMUNITY COLLEGE,4236,4145,91,5213,1512,3701,0,0,0,0,4236,5213,1687,424,9449,5973.67
2010,44,ORANGE,0,SUNY,0,PUBLIC,0,2-Year,276900,800000040366,ORANGE COUNTY COMMUNITY COLLEGE,3861,3717,144,3205,1954,1251,0,0,0,0,3861,3205,1333,380,7066,4929.33
2011,44,ORANGE,0,SUNY,0,PUBLIC,0,2-Year,276900,800000040366,ORANGE COUNTY COMMUNITY COLLEGE,3638,3520,118,3666,2264,1402,0,0,0,0,3638,3666,1321,447,7304,4860
2012,44,ORANGE,0,SUNY,0,PUBLIC,0,2-Year,276900,800000040366,ORANGE COUNTY COMMUNITY COLLEGE,3462,3363,99,3795,2232,1563,0,0,0,0,3462,3795,1239,421,7257,4727
2013,44,ORANGE,0,SUNY,0,PUBLIC,0,2-Year,276900,800000040366,ORANGE COUNTY COMMUNITY COLLEGE,3338,3301,37,3691,2279,1412,0,0,0,0,3338,3691,1194,301,7029,4568.33
2014,44,ORANGE,0,SUNY,0,PUBLIC,0,2-Year,276900,800000040366,ORANGE COUNTY COMMUNITY COLLEGE,3323,3295,28,3628,2118,1510,0,0,0,0,3323,3628,1168,299,6951,4532.33
2015,44,ORANGE,0,SUNY,0,PUBLIC,0,2-Year,276900,800000040366,ORANGE COUNTY COMMUNITY COLLEGE,3226,3189,37,3756,2165,1591,0,0,0,0,3226,3756,1092,281,6982,4478
2016,44,ORANGE,0,SUNY,0,PUBLIC,0,2-Year,276900,800000040366,ORANGE COUNTY COMMUNITY COLLEGE,2878,2836,42,3542,1992,1550,0,0,0,0,2878,3542,1038,266,6420,4058.67
2017,44,ORANGE,0,SUNY,0,PUBLIC,0,2-Year,276900,800000040366,ORANGE COUNTY COMMUNITY COLLEGE,2746,2671,75,3392,1771,1621,0,0,0,0,2746,3392,1057,192,6138,3876.67
2018,44,ORANGE,0,SUNY,0,PUBLIC,0,2-Year,276900,800000040366,ORANGE COUNTY COMMUNITY COLLEGE,2639,2563,76,3454,1834,1620,0,0,0,0,2639,3454,981,266,6093,3790.33
2019,44,ORANGE,0,SUNY,0,PUBLIC,0,2-Year,276900,800000040366,ORANGE COUNTY COMMUNITY COLLEGE,2390,2313,77,3453,1773,1680,0,0,0,0,2390,3453,826,239,5843,3541
2016,44,ORANGE,0,SUNY,0,PUBLIC,0,2-Year,276910,800000064835,ORANGE COUNTY COMM COLLEGE - NEWBURGH,273,273,0,170,170,0,0,0,0,0,273,170,88,19,443,329.67
2017,44,ORANGE,0,SUNY,0,PUBLIC,0,2-Year,276910,800000064835,ORANGE COUNTY COMM COLLEGE - NEWBURGH,265,265,0,196,196,0,0,0,0,0,265,196,108,15,461,330.33
2018,44,ORANGE,0,SUNY,0,PUBLIC,0,2-Year,276910,800000064835,ORANGE COUNTY COMM COLLEGE - NEWBURGH,325,325,0,199,199,0,0,0,0,0,325,199,123,22,524,391.33
2019,44,ORANGE,0,SUNY,0,PUBLIC,0,2-Year,276910,800000064835,ORANGE COUNTY COMM COLLEGE - NEWBURGH,290,290,0,239,239,0,0,0,0,0,290,239,90,20,529,369.67
2010,50,ROCKLAND,0,SUNY,0,PUBLIC,0,2-Year,277200,800000039132,ROCKLAND COMMUNITY COLLEGE,5078,5076,2,2999,1900,1099,0,0,0,0,5078,2999,1516,90,8077,6077.67
2011,50,ROCKLAND,0,SUNY,0,PUBLIC,0,2-Year,277200,800000039132,ROCKLAND COMMUNITY COLLEGE,4754,4751,3,3292,2164,1128,0,0,0,0,4754,3292,1486,130,8046,5851.33
2012,50,ROCKLAND,0,SUNY,0,PUBLIC,0,2-Year,277200,800000039132,ROCKLAND COMMUNITY COLLEGE,4916,4695,221,3847,2154,1693,0,0,0,0,4916,3847,1489,115,8763,6198.33
2013,50,ROCKLAND,0,SUNY,0,PUBLIC,0,2-Year,277200,800000039132,ROCKLAND COMMUNITY COLLEGE,4483,4467,16,3163,2083,1080,0,0,0,0,4483,3163,1512,170,7646,5537.33
2014,50,ROCKLAND,0,SUNY,0,PUBLIC,0,2-Year,277200,800000039132,ROCKLAND COMMUNITY COLLEGE,4200,4185,15,3321,2157,1164,0,0,0,0,4200,3321,1403,195,7521,5307
2015,50,ROCKLAND,0,SUNY,0,PUBLIC,0,2-Year,277200,800000039132,ROCKLAND COMMUNITY COLLEGE,4023,3984,39,3202,2054,1148,0,0,0,0,4023,3202,1424,242,7225,5090.33
2016,50,ROCKLAND,0,SUNY,0,PUBLIC,0,2-Year,277200,800000039132,ROCKLAND COMMUNITY COLLEGE,3825,3777,48,3352,2056,1296,0,0,0,0,3825,3352,1388,268,7177,4942.33
2017,50,ROCKLAND,0,SUNY,0,PUBLIC,0,2-Year,277200,800000039132,ROCKLAND COMMUNITY COLLEGE,3674,3616,58,3276,1979,1297,0,0,0,0,3674,3276,1338,228,6950,4766
2018,50,ROCKLAND,0,SUNY,0,PUBLIC,0,2-Year,277200,800000039132,ROCKLAND COMMUNITY COLLEGE,3540,3469,71,3317,1967,1350,0,0,0,0,3540,3317,1295,270,6857,4645.67
2019,50,ROCKLAND,0,SUNY,0,PUBLIC,0,2-Year,277200,800000039132,ROCKLAND COMMUNITY COLLEGE,3312,3291,21,3367,1926,1441,0,0,0,0,3312,3367,1290,286,6679,4434.33
2010,53,SCHENECTADY,0,SUNY,0,PUBLIC,0,2-Year,277500,800000038336,SCHENECTADY COUNTY COMMUNITY COLLEGE,2765,2648,117,3650,1097,2553,0,0,0,0,2765,3650,847,349,6415,3981.67
2011,53,SCHENECTADY,0,SUNY,0,PUBLIC,0,2-Year,277500,800000038336,SCHENECTADY COUNTY COMMUNITY COLLEGE,2668,2587,81,4091,1229,2862,0,0,0,0,2668,4091,867,429,6759,4031.67
2012,53,SCHENECTADY,0,SUNY,0,PUBLIC,0,2-Year,277500,800000038336,SCHENECTADY COUNTY COMMUNITY COLLEGE,2730,2661,69,3941,1259,2682,0,0,0,0,2730,3941,851,302,6671,4043.67
2013,53,SCHENECTADY,0,SUNY,0,PUBLIC,0,2-Year,277500,800000038336,SCHENECTADY COUNTY COMMUNITY COLLEGE,2747,2671,76,3827,1203,2624,0,0,0,0,2747,3827,931,279,6574,4022.67
2014,53,SCHENECTADY,0,SUNY,0,PUBLIC,0,2-Year,277500,800000038336,SCHENECTADY COUNTY COMMUNITY COLLEGE,2562,2502,60,3935,1300,2635,0,0,0,0,2562,3935,771,272,6497,3873.67
2015,53,SCHENECTADY,0,SUNY,0,PUBLIC,0,2-Year,277500,800000038336,SCHENECTADY COUNTY COMMUNITY COLLEGE,2234,2169,65,3892,1130,2762,0,0,0,0,2234,3892,699,284,6126,3531.33
2016,53,SCHENECTADY,0,SUNY,0,PUBLIC,0,2-Year,277500,800000038336,SCHENECTADY COUNTY COMMUNITY COLLEGE,2029,1926,103,4378,1067,3311,0,0,0,0,2029,4378,585,276,6407,3488.33
2017,53,SCHENECTADY,0,SUNY,0,PUBLIC,0,2-Year,277500,800000038336,SCHENECTADY COUNTY COMMUNITY COLLEGE,2144,1823,321,4444,1117,3327,0,0,0,0,2144,4444,679,259,6588,3625.33
2018,53,SCHENECTADY,0,SUNY,0,PUBLIC,0,2-Year,277500,800000038336,SCHENECTADY COUNTY COMMUNITY COLLEGE,1729,1664,65,3502,1013,2489,0,0,0,0,1729,3502,529,191,5231,2896.33
2019,53,SCHENECTADY,0,SUNY,0,PUBLIC,0,2-Year,277500,800000038336,SCHENECTADY COUNTY COMMUNITY COLLEGE,1555,1472,83,3177,839,2338,0,0,0,0,1555,3177,469,171,4732,2614
2010,58,SUFFOLK,0,SUNY,0,PUBLIC,0,2-Year,277800,800000037581,SUFFOLK COUNTY COMMUNITY COLLEGE,15985,15935,50,10734,7457,3277,0,0,0,0,15985,10734,4883,2562,26719,19563
2011,58,SUFFOLK,0,SUNY,0,PUBLIC,0,2-Year,277800,800000037581,SUFFOLK COUNTY COMMUNITY COLLEGE,15064,15019,45,11723,8313,3410,0,0,0,0,15064,11723,4454,2725,26787,18971.67
2012,58,SUFFOLK,0,SUNY,0,PUBLIC,0,2-Year,277800,800000037581,SUFFOLK COUNTY COMMUNITY COLLEGE,14843,14795,48,11376,7973,3403,0,0,0,0,14843,11376,4555,1360,26219,18635
2013,58,SUFFOLK,0,SUNY,0,PUBLIC,0,2-Year,277800,800000037581,SUFFOLK COUNTY COMMUNITY COLLEGE,14831,14813,18,11880,7888,3992,0,0,0,0,14831,11880,4604,1327,26711,18791
2014,58,SUFFOLK,0,SUNY,0,PUBLIC,0,2-Year,277800,800000037581,SUFFOLK COUNTY COMMUNITY COLLEGE,14318,14293,25,12282,7929,4353,0,0,0,0,14318,12282,4603,1275,26600,18412
2015,58,SUFFOLK,0,SUNY,0,PUBLIC,0,2-Year,277800,800000037581,SUFFOLK COUNTY COMMUNITY COLLEGE,14722,14694,28,12107,7107,5000,0,0,0,0,14722,12107,4751,1110,26829,18757.67
2016,58,SUFFOLK,0,SUNY,0,PUBLIC,0,2-Year,277800,800000037581,SUFFOLK COUNTY COMMUNITY COLLEGE,7296,7274,22,5153,3154,1999,0,0,0,0,7296,5153,2078,487,12449,9013.67
2017,58,SUFFOLK,0,SUNY,0,PUBLIC,0,2-Year,277800,800000037581,SUFFOLK COUNTY COMMUNITY COLLEGE,7168,7147,21,5342,2954,2388,0,0,0,0,7168,5342,2214,512,12510,8948.67
2018,58,SUFFOLK,0,SUNY,0,PUBLIC,0,2-Year,277800,800000037581,SUFFOLK COUNTY COMMUNITY COLLEGE,6829,6804,25,5545,2976,2569,0,0,0,0,6829,5545,1973,552,12374,8677.33
2019,58,SUFFOLK,0,SUNY,0,PUBLIC,0,2-Year,277800,800000037581,SUFFOLK COUNTY COMMUNITY COLLEGE,6437,6409,28,5485,2898,2587,0,0,0,0,6437,5485,1882,485,11922,8265.33
2016,58,SUFFOLK,0,SUNY,0,PUBLIC,0,2-Year,277810,800000036942,SUFFOLK COUNTY COMMUNITY COLLEGE EASTERN CAMPUS,1920,1901,19,2155,1029,1126,0,0,0,0,1920,2155,554,162,4075,2638.33
2017,58,SUFFOLK,0,SUNY,0,PUBLIC,0,2-Year,277810,800000036942,SUFFOLK COUNTY COMMUNITY COLLEGE EASTERN CAMPUS,1898,1867,31,1783,978,805,0,0,0,0,1898,1783,593,193,3681,2492.33
2018,58,SUFFOLK,0,SUNY,0,PUBLIC,0,2-Year,277810,800000036942,SUFFOLK COUNTY COMMUNITY COLLEGE EASTERN CAMPUS,1815,1795,20,1965,1026,939,0,0,0,0,1815,1965,578,200,3780,2470
2019,58,SUFFOLK,0,SUNY,0,PUBLIC,0,2-Year,277810,800000036942,SUFFOLK COUNTY COMMUNITY COLLEGE EASTERN CAMPUS,1697,1679,18,2088,981,1107,0,0,0,0,1697,2088,509,179,3785,2393
2016,58,SUFFOLK,0,SUNY,0,PUBLIC,0,2-Year,277820,800000037016,SUFFOLK COUNTY COMMUNITY COLLEGE WESTERN CAMPUS,4868,4863,5,5674,3010,2664,0,0,0,0,4868,5674,1477,447,10542,6759.33
2017,58,SUFFOLK,0,SUNY,0,PUBLIC,0,2-Year,277820,800000037016,SUFFOLK COUNTY COMMUNITY COLLEGE WESTERN CAMPUS,4812,4807,5,5753,2816,2937,0,0,0,0,4812,5753,1614,379,10565,6729.67
2018,58,SUFFOLK,0,SUNY,0,PUBLIC,0,2-Year,277820,800000037016,SUFFOLK COUNTY COMMUNITY COLLEGE WESTERN CAMPUS,4591,4573,18,5344,2774,2570,0,0,0,0,4591,5344,1500,447,9935,6372.33
2019,58,SUFFOLK,0,SUNY,0,PUBLIC,0,2-Year,277820,800000037016,SUFFOLK COUNTY COMMUNITY COLLEGE WESTERN CAMPUS,4265,4250,15,5258,2645,2613,0,0,0,0,4265,5258,1381,370,9523,6017.67
2010,59,SULLIVAN,0,SUNY,0,PUBLIC,0,2-Year,278100,800000036677,SULLIVAN COUNTY COMMUNITY COLLEGE,1127,1097,30,622,312,310,0,0,0,0,1127,622,491,38,1749,1334.33
2011,59,SULLIVAN,0,SUNY,0,PUBLIC,0,2-Year,278100,800000036677,SULLIVAN COUNTY COMMUNITY COLLEGE,1134,1107,27,571,248,323,0,0,0,0,1134,571,426,55,1705,1324.33
2012,59,SULLIVAN,0,SUNY,0,PUBLIC,0,2-Year,278100,800000036677,SULLIVAN COUNTY COMMUNITY COLLEGE,1040,998,42,575,262,313,0,0,0,0,1040,575,395,36,1615,1231.67
2013,59,SULLIVAN,0,SUNY,0,PUBLIC,0,2-Year,278100,800000036677,SULLIVAN COUNTY COMMUNITY COLLEGE,1020,999,21,535,283,252,0,0,0,0,1020,535,374,25,1555,1198.33
2014,59,SULLIVAN,0,SUNY,0,PUBLIC,0,2-Year,278100,800000036677,SULLIVAN COUNTY COMMUNITY COLLEGE,930,907,23,713,236,477,0,0,0,0,930,713,329,20,1643,1167.67
2015,59,SULLIVAN,0,SUNY,0,PUBLIC,0,2-Year,278100,800000036677,SULLIVAN COUNTY COMMUNITY COLLEGE,809,793,16,787,287,500,0,0,0,0,809,787,272,46,1596,1071.33
2016,59,SULLIVAN,0,SUNY,0,PUBLIC,0,2-Year,278100,800000036677,SULLIVAN COUNTY COMMUNITY COLLEGE,820,806,14,790,266,524,0,0,0,0,820,790,330,30,1610,1083.33
2017,59,SULLIVAN,0,SUNY,0,PUBLIC,0,2-Year,278100,800000036677,SULLIVAN COUNTY COMMUNITY COLLEGE,843,821,22,721,209,512,0,0,0,0,843,721,325,33,1564,1083.33
2018,59,SULLIVAN,0,SUNY,0,PUBLIC,0,2-Year,278100,800000036677,SULLIVAN COUNTY COMMUNITY COLLEGE,784,752,32,750,244,506,0,0,0,0,784,750,293,47,1534,1034
2019,59,SULLIVAN,0,SUNY,0,PUBLIC,0,2-Year,278100,800000036677,SULLIVAN COUNTY COMMUNITY COLLEGE,780,756,24,851,318,533,0,0,0,0,780,851,328,40,1631,1063.67
2010,61,TOMPKINS,0,SUNY,0,PUBLIC,0,2-Year,278400,800000036456,TOMPKINS CORTLAND COMMUNITY COLLEGE,2985,2928,57,2528,629,1899,0,0,0,0,2985,2528,1078,74,5513,3827.67
2011,61,TOMPKINS,0,SUNY,0,PUBLIC,0,2-Year,278400,800000036456,TOMPKINS CORTLAND COMMUNITY COLLEGE,2930,2803,127,2732,680,2052,0,0,0,0,2930,2732,1072,66,5662,3840.67
2012,61,TOMPKINS,0,SUNY,0,PUBLIC,0,2-Year,278400,800000036456,TOMPKINS CORTLAND COMMUNITY COLLEGE,2686,2578,108,2764,641,2123,0,0,0,0,2686,2764,958,86,5450,3607.33
2013,61,TOMPKINS,0,SUNY,0,PUBLIC,0,2-Year,278400,800000036456,TOMPKINS CORTLAND COMMUNITY COLLEGE,2587,2468,119,2903,572,2331,0,0,0,0,2587,2903,845,66,5490,3554.67
2014,61,TOMPKINS,0,SUNY,0,PUBLIC,0,2-Year,278400,800000036456,TOMPKINS CORTLAND COMMUNITY COLLEGE,2328,2244,84,3231,615,2616,0,0,0,0,2328,3231,774,93,5559,3405
2015,61,TOMPKINS,0,SUNY,0,PUBLIC,0,2-Year,278400,800000036456,TOMPKINS CORTLAND COMMUNITY COLLEGE,2227,2113,114,3714,599,3115,0,0,0,0,2227,3714,781,86,5941,3465
2016,61,TOMPKINS,0,SUNY,0,PUBLIC,0,2-Year,278400,800000036456,TOMPKINS CORTLAND COMMUNITY COLLEGE,2028,1913,115,3723,589,3134,0,0,0,0,2028,3723,715,72,5751,3269
2017,61,TOMPKINS,0,SUNY,0,PUBLIC,0,2-Year,278400,800000036456,TOMPKINS CORTLAND COMMUNITY COLLEGE,1917,1747,170,3429,523,2906,0,0,0,0,1917,3429,625,58,5346,3060
2018,61,TOMPKINS,0,SUNY,0,PUBLIC,0,2-Year,278400,800000036456,TOMPKINS CORTLAND COMMUNITY COLLEGE,1695,1549,146,3309,517,2792,0,0,0,0,1695,3309,587,61,5004,2798
2019,61,TOMPKINS,0,SUNY,0,PUBLIC,0,2-Year,278400,800000036456,TOMPKINS CORTLAND COMMUNITY COLLEGE,1546,1406,140,3500,490,3010,0,0,0,0,1546,3500,537,68,5046,2712.67
2010,62,ULSTER,0,SUNY,0,PUBLIC,0,2-Year,279000,800000036209,ULSTER COUNTY COMMUNITY COLLEGE,1804,1743,61,1882,725,1157,0,0,0,0,1804,1882,629,214,3686,2431.33
2011,62,ULSTER,0,SUNY,0,PUBLIC,0,2-Year,279000,800000036209,ULSTER COUNTY COMMUNITY COLLEGE,1639,1594,45,1980,704,1276,0,0,0,0,1639,1980,604,195,3619,2299
2012,62,ULSTER,0,SUNY,0,PUBLIC,0,2-Year,279000,800000036209,ULSTER COUNTY COMMUNITY COLLEGE,1567,1496,71,2114,736,1378,0,0,0,0,1567,2114,580,252,3681,2271.67
2013,62,ULSTER,0,SUNY,0,PUBLIC,0,2-Year,279000,800000036209,ULSTER COUNTY COMMUNITY COLLEGE,1654,1578,76,1961,656,1305,0,0,0,0,1654,1961,594,157,3615,2307.67
2014,62,ULSTER,0,SUNY,0,PUBLIC,0,2-Year,279000,800000036209,ULSTER COUNTY COMMUNITY COLLEGE,1584,1489,95,2010,636,1374,0,0,0,0,1584,2010,542,154,3594,2254
2015,62,ULSTER,0,SUNY,0,PUBLIC,0,2-Year,279000,800000036209,ULSTER COUNTY COMMUNITY COLLEGE,1437,1296,141,2026,599,1427,0,0,0,0,1437,2026,470,156,3463,2112.33
2016,62,ULSTER,0,SUNY,0,PUBLIC,0,2-Year,279000,800000036209,ULSTER COUNTY COMMUNITY COLLEGE,1380,1224,156,2036,644,1392,0,0,0,0,1380,2036,418,113,3416,2058.67
2017,62,ULSTER,0,SUNY,0,PUBLIC,0,2-Year,279000,800000036209,ULSTER COUNTY COMMUNITY COLLEGE,1454,1282,172,2106,699,1407,0,0,0,0,1454,2106,483,137,3560,2156
2018,62,ULSTER,0,SUNY,0,PUBLIC,0,2-Year,279000,800000036209,ULSTER COUNTY COMMUNITY COLLEGE,1420,1238,182,2134,653,1481,0,0,0,0,1420,2134,430,118,3554,2131.33
2019,62,ULSTER,0,SUNY,0,PUBLIC,0,2-Year,279000,800000036209,ULSTER COUNTY COMMUNITY COLLEGE,1424,1158,266,2126,646,1480,0,0,0,0,1424,2126,436,116,3550,2132.67
2010,66,WESTCHESTER,0,SUNY,0,PUBLIC,0,2-Year,279300,800000035311,WESTCHESTER COMMUNITY COLLEGE,7543,7273,270,6350,4633,1717,0,0,0,0,7543,6350,2328,849,13893,9659.67
2011,66,WESTCHESTER,0,SUNY,0,PUBLIC,0,2-Year,279300,800000035311,WESTCHESTER COMMUNITY COLLEGE,7398,7134,264,6212,4952,1260,0,0,0,0,7398,6212,2313,827,13610,9468.67
2012,66,WESTCHESTER,0,SUNY,0,PUBLIC,0,2-Year,279300,800000035311,WESTCHESTER COMMUNITY COLLEGE,7618,7408,210,6379,4882,1497,0,0,0,0,7618,6379,2306,810,13997,9744.33
2013,66,WESTCHESTER,0,SUNY,0,PUBLIC,0,2-Year,279300,800000035311,WESTCHESTER COMMUNITY COLLEGE,7640,7434,206,6141,4800,1341,0,0,0,0,7640,6141,2151,703,13781,9687
2014,66,WESTCHESTER,0,SUNY,0,PUBLIC,0,2-Year,279300,800000035311,WESTCHESTER COMMUNITY COLLEGE,7546,7359,187,6370,4898,1472,0,0,0,0,7546,6370,2108,712,13916,9669.33
2015,66,WESTCHESTER,0,SUNY,0,PUBLIC,0,2-Year,279300,800000035311,WESTCHESTER COMMUNITY COLLEGE,7062,6898,164,5904,4791,1113,0,0,0,0,7062,5904,1878,691,12966,9030
2016,66,WESTCHESTER,0,SUNY,0,PUBLIC,0,2-Year,279300,800000035311,WESTCHESTER COMMUNITY COLLEGE,6973,6794,179,5869,4831,1038,0,0,0,0,6973,5869,1948,760,12842,8929.33
2017,66,WESTCHESTER,0,SUNY,0,PUBLIC,0,2-Year,279300,800000035311,WESTCHESTER COMMUNITY COLLEGE,6748,6543,205,5823,4680,1143,0,0,0,0,6748,5823,2159,856,12571,8689
2018,66,WESTCHESTER,0,SUNY,0,PUBLIC,0,2-Year,279300,800000035311,WESTCHESTER COMMUNITY COLLEGE,6156,5853,303,5379,4444,935,0,0,0,0,6156,5379,2059,642,11535,7949
2019,66,WESTCHESTER,0,SUNY,0,PUBLIC,0,2-Year,279300,800000035311,WESTCHESTER COMMUNITY COLLEGE,5685,5543,142,5436,4335,1101,0,0,0,0,5685,5436,1954,741,11121,7497
2010,31,NEW YORK,1,CUNY,0,PUBLIC,1,4-Year/Grad,310500,800000047620,CUNY GRADUATE SCHOOL AND UNIVERSITY CENTER,284,284,0,852,718,134,0,0,4377,1077,4661,1929,0,18,6590,5375.8
2011,31,NEW YORK,1,CUNY,0,PUBLIC,1,4-Year/Grad,310500,800000047620,CUNY GRADUATE SCHOOL AND UNIVERSITY CENTER,271,270,1,949,764,185,0,0,4472,1090,4743,2039,0,0,6782,5495.33
2012,31,NEW YORK,1,CUNY,0,PUBLIC,1,4-Year/Grad,310500,800000047620,CUNY GRADUATE SCHOOL AND UNIVERSITY CENTER,308,307,1,939,770,169,0,0,4352,1213,4660,2152,3,37,6812,5458.2
2013,31,NEW YORK,1,CUNY,0,PUBLIC,1,4-Year/Grad,310500,800000047620,CUNY GRADUATE SCHOOL AND UNIVERSITY CENTER,296,293,3,1051,819,232,0,0,4158,1231,4454,2282,0,0,6736,5296.73
2014,31,NEW YORK,1,CUNY,0,PUBLIC,1,4-Year/Grad,310500,800000047620,CUNY GRADUATE SCHOOL AND UNIVERSITY CENTER,342,340,2,1342,957,385,0,0,3978,1351,4320,2693,0,0,7013,5307.73
2015,31,NEW YORK,1,CUNY,0,PUBLIC,1,4-Year/Grad,310500,800000047620,CUNY GRADUATE SCHOOL AND UNIVERSITY CENTER,350,349,1,1445,1114,331,0,0,3794,1257,4144,2702,0,0,6846,5128.47
2016,31,NEW YORK,1,CUNY,0,PUBLIC,1,4-Year/Grad,310500,800000047620,CUNY GRADUATE SCHOOL AND UNIVERSITY CENTER,354,352,2,1440,1294,146,0,0,3630,1954,3984,3394,0,0,7378,5245.6
2017,31,NEW YORK,1,CUNY,0,PUBLIC,1,4-Year/Grad,310500,800000047620,CUNY GRADUATE SCHOOL AND UNIVERSITY CENTER,418,417,1,1648,1437,211,0,0,3540,2068,3958,3716,0,0,7674,5334.53
2018,31,NEW YORK,1,CUNY,0,PUBLIC,1,4-Year/Grad,310500,800000047620,CUNY GRADUATE SCHOOL AND UNIVERSITY CENTER,411,409,2,1876,1696,180,0,0,3488,2266,3899,4142,0,0,8041,5430.73
2019,31,NEW YORK,1,CUNY,0,PUBLIC,1,4-Year/Grad,310500,800000047620,CUNY GRADUATE SCHOOL AND UNIVERSITY CENTER,468,467,1,2030,1782,248,0,0,3628,2377,4096,4407,0,7,8503,5723.47
2010,34,QUEENS,1,CUNY,0,PUBLIC,1,4-Year/Grad,311000,800000043091,CUNY LAW SCHOOL AT QUEENS,0,0,0,0,0,0,431,0,8,2,439,2,0,0,441,439.8
2011,34,QUEENS,1,CUNY,0,PUBLIC,1,4-Year/Grad,311000,800000043091,CUNY LAW SCHOOL AT QUEENS,0,0,0,0,0,0,478,3,0,0,478,3,0,0,481,479.2
2012,34,QUEENS,1,CUNY,0,PUBLIC,1,4-Year/Grad,311000,800000043091,CUNY LAW SCHOOL AT QUEENS,0,0,0,0,0,0,426,5,0,0,426,5,0,0,431,428
2013,34,QUEENS,1,CUNY,0,PUBLIC,1,4-Year/Grad,311000,800000043091,CUNY LAW SCHOOL AT QUEENS,0,0,0,0,0,0,377,2,3,1,380,3,0,0,383,381.2
2014,34,QUEENS,1,CUNY,0,PUBLIC,1,4-Year/Grad,311000,800000043091,CUNY LAW SCHOOL AT QUEENS,0,0,0,0,0,0,319,1,3,2,322,3,0,0,325,323.2
2015,34,QUEENS,1,CUNY,0,PUBLIC,1,4-Year/Grad,311000,800000043091,CUNY LAW SCHOOL AT QUEENS,0,0,0,0,0,0,311,50,0,0,311,50,0,0,361,331
2016,34,QUEENS,1,CUNY,0,PUBLIC,1,4-Year/Grad,311000,800000043091,CUNY LAW SCHOOL AT QUEENS,0,0,0,0,0,0,340,96,0,0,340,96,0,0,436,378.4
2017,34,QUEENS,1,CUNY,0,PUBLIC,1,4-Year/Grad,311000,800000043091,CUNY LAW SCHOOL AT QUEENS,0,0,0,0,0,0,344,144,0,0,344,144,0,0,488,401.6
2018,34,QUEENS,1,CUNY,0,PUBLIC,1,4-Year/Grad,311000,800000043091,CUNY LAW SCHOOL AT QUEENS,0,0,0,0,0,0,417,160,0,0,417,160,0,0,577,481
2019,34,QUEENS,1,CUNY,0,PUBLIC,1,4-Year/Grad,311000,800000043091,CUNY LAW SCHOOL AT QUEENS,0,0,0,0,0,0,434,189,0,3,434,192,0,0,626,510.8
2010,31,NEW YORK,1,CUNY,0,PUBLIC,1,4-Year/Grad,330500,800000047621,CUNY BERNARD M. BARUCH COLLEGE,10018,10011,7,3102,2791,311,0,0,1032,2911,11050,6013,1255,5,17063,13248.4
2011,31,NEW YORK,1,CUNY,0,PUBLIC,1,4-Year/Grad,330500,800000047621,CUNY BERNARD M. BARUCH COLLEGE,10574,10569,5,3692,3369,323,0,0,941,2848,11515,6540,1301,10,18055,13884.87
2012,31,NEW YORK,1,CUNY,0,PUBLIC,1,4-Year/Grad,330500,800000047621,CUNY BERNARD M. BARUCH COLLEGE,10365,10363,2,3412,3221,191,0,0,806,2790,11171,6202,1171,14,17373,13424.33
2013,31,NEW YORK,1,CUNY,0,PUBLIC,1,4-Year/Grad,330500,800000047621,CUNY BERNARD M. BARUCH COLLEGE,10396,10393,3,3686,3305,381,0,0,826,2597,11222,6283,1245,9,17505,13489.47
2014,31,NEW YORK,1,CUNY,0,PUBLIC,1,4-Year/Grad,330500,800000047621,CUNY BERNARD M. BARUCH COLLEGE,10865,10796,69,3992,3624,368,0,0,744,2489,11609,6481,1274,8,18090,13935.27
2015,31,NEW YORK,1,CUNY,0,PUBLIC,1,4-Year/Grad,330500,800000047621,CUNY BERNARD M. BARUCH COLLEGE,11233,11175,58,4021,3721,300,0,0,742,2437,11975,6458,1468,9,18433,14290.13
2016,31,NEW YORK,1,CUNY,0,PUBLIC,1,4-Year/Grad,330500,800000047621,CUNY BERNARD M. BARUCH COLLEGE,11288,11238,50,3922,3620,302,0,0,642,2434,11930,6356,1400,4,18286,14210.93
2017,31,NEW YORK,1,CUNY,0,PUBLIC,1,4-Year/Grad,330500,800000047621,CUNY BERNARD M. BARUCH COLLEGE,11598,11541,57,3655,3362,293,0,0,633,2403,12231,6058,1599,6,18289,14410.53
2018,31,NEW YORK,1,CUNY,0,PUBLIC,1,4-Year/Grad,330500,800000047621,CUNY BERNARD M. BARUCH COLLEGE,11495,11442,53,3529,3187,342,0,0,547,2458,12042,5987,1682,10,18029,14201.53
2019,31,NEW YORK,1,CUNY,0,PUBLIC,1,4-Year/Grad,330500,800000047621,CUNY BERNARD M. BARUCH COLLEGE,12091,12032,59,3391,3034,357,0,0,687,2510,12778,5901,2261,7,18679,14912.33
2010,33,KINGS,1,CUNY,0,PUBLIC,1,4-Year/Grad,331000,800000043781,CITY UNIVERSITY OF NEW YORK BROOKLYN COLLEGE,9162,9110,52,3681,2738,943,0,0,610,3296,9772,6977,1158,12,16749,12317.4
2011,33,KINGS,1,CUNY,0,PUBLIC,1,4-Year/Grad,331000,800000043781,CITY UNIVERSITY OF NEW YORK BROOKLYN COLLEGE,9310,9254,56,3786,2908,878,0,0,625,3114,9935,6900,1139,14,16835,12442.6
2012,33,KINGS,1,CUNY,0,PUBLIC,1,4-Year/Grad,331000,800000043781,CITY UNIVERSITY OF NEW YORK BROOKLYN COLLEGE,9238,9179,59,3861,2946,915,0,0,528,2897,9766,6758,1140,8,16524,12211.8
2013,33,KINGS,1,CUNY,0,PUBLIC,1,4-Year/Grad,331000,800000043781,CITY UNIVERSITY OF NEW YORK BROOKLYN COLLEGE,9543,9464,79,4053,3161,892,0,0,518,2890,10061,6943,1183,10,17004,12568
2014,33,KINGS,1,CUNY,0,PUBLIC,1,4-Year/Grad,331000,800000043781,CITY UNIVERSITY OF NEW YORK BROOKLYN COLLEGE,9897,9812,85,4218,3113,1105,0,0,489,2786,10386,7004,1347,11,17390,12906.4
2015,33,KINGS,1,CUNY,0,PUBLIC,1,4-Year/Grad,331000,800000043781,CITY UNIVERSITY OF NEW YORK BROOKLYN COLLEGE,10175,10080,95,4032,3092,940,0,0,560,2643,10735,6675,1327,13,17410,13136.2
2016,33,KINGS,1,CUNY,0,PUBLIC,1,4-Year/Grad,331000,800000043781,CITY UNIVERSITY OF NEW YORK BROOKLYN COLLEGE,10198,10118,80,4208,3262,946,0,0,597,2577,10795,6785,1320,10,17580,13228.47
2017,33,KINGS,1,CUNY,0,PUBLIC,1,4-Year/Grad,331000,800000043781,CITY UNIVERSITY OF NEW YORK BROOKLYN COLLEGE,10786,10668,118,3903,3044,859,0,0,618,2496,11404,6399,1642,20,17803,13703.4
2018,33,KINGS,1,CUNY,0,PUBLIC,1,4-Year/Grad,331000,800000043781,CITY UNIVERSITY OF NEW YORK BROOKLYN COLLEGE,11142,11026,116,3836,2928,908,0,0,595,2588,11737,6424,1738,18,18161,14050.87
2019,33,KINGS,1,CUNY,0,PUBLIC,1,4-Year/Grad,331000,800000043781,CITY UNIVERSITY OF NEW YORK BROOKLYN COLLEGE,11189,11053,136,3781,2900,881,0,0,544,2297,11733,6078,1882,12,17811,13912.13
2010,31,NEW YORK,1,CUNY,0,PUBLIC,1,4-Year/Grad,331500,800000047047,CUNY CITY COLLEGE,9313,9255,58,2950,2427,523,0,0,450,2703,9763,5653,1368,21,15416,11827.53
2011,31,NEW YORK,1,CUNY,0,PUBLIC,1,4-Year/Grad,331500,800000047047,CUNY CITY COLLEGE,9552,9447,105,3311,2766,545,0,0,446,2696,9998,6007,1501,16,16005,12180.07
2012,31,NEW YORK,1,CUNY,0,PUBLIC,1,4-Year/Grad,331500,800000047047,CUNY CITY COLLEGE,9524,9421,103,3459,2751,708,0,0,474,2566,9998,6025,1381,16,16023,12177.4
2013,31,NEW YORK,1,CUNY,0,PUBLIC,1,4-Year/Grad,331500,800000047047,CUNY CITY COLLEGE,9274,9202,72,3227,2618,609,0,0,447,2383,9721,5610,1431,13,15331,11749.87
2014,31,NEW YORK,1,CUNY,0,PUBLIC,1,4-Year/Grad,331500,800000047047,CUNY CITY COLLEGE,9430,9299,131,3463,2876,587,0,0,415,2271,9845,5734,1425,16,15579,11907.73
2015,31,NEW YORK,1,CUNY,0,PUBLIC,1,4-Year/Grad,331500,800000047047,CUNY CITY COLLEGE,9734,9636,98,3467,2830,637,0,0,376,2201,10110,5668,1607,23,15778,12146.07
2016,31,NEW YORK,1,CUNY,0,PUBLIC,1,4-Year/Grad,331500,800000047047,CUNY CITY COLLEGE,10067,9965,102,3250,2644,606,100,0,363,2268,10530,5518,1805,22,16048,12520.53
2017,31,NEW YORK,1,CUNY,0,PUBLIC,1,4-Year/Grad,331500,800000047047,CUNY CITY COLLEGE,10225,10099,126,2985,2381,604,0,0,551,2240,10776,5225,1683,22,16001,12667
2018,31,NEW YORK,1,CUNY,0,PUBLIC,1,4-Year/Grad,331500,800000047047,CUNY CITY COLLEGE,10248,10133,115,2938,2370,568,202,0,399,2256,10849,5194,1804,26,16043,12730.73
2019,31,NEW YORK,1,CUNY,0,PUBLIC,1,4-Year/Grad,331500,800000047047,CUNY CITY COLLEGE,10196,10094,102,2834,2265,569,251,0,591,1944,11038,4778,2054,38,15816,12760.27
2010,35,RICHMOND,1,CUNY,0,PUBLIC,1,4-Year/Grad,331800,800000041831,CITY UNIVERSITY OF NEW YORK COLLEGE OF STATEN ISLAND,9502,9480,22,3327,2974,353,0,0,124,941,9626,4268,2237,105,13894,11111.4
2011,35,RICHMOND,1,CUNY,0,PUBLIC,1,4-Year/Grad,331800,800000041831,CITY UNIVERSITY OF NEW YORK COLLEGE OF STATEN ISLAND,9639,9613,26,3516,3192,324,0,0,111,933,9750,4449,2293,165,14199,11295.2
2012,35,RICHMOND,1,CUNY,0,PUBLIC,1,4-Year/Grad,331800,800000041831,CITY UNIVERSITY OF NEW YORK COLLEGE OF STATEN ISLAND,9917,9896,21,3447,3081,366,0,0,121,836,10038,4283,2402,154,14321,11521.4
2013,35,RICHMOND,1,CUNY,0,PUBLIC,1,4-Year/Grad,331800,800000041831,CITY UNIVERSITY OF NEW YORK COLLEGE OF STATEN ISLAND,9784,9758,26,3681,3216,465,0,0,116,860,9900,4541,2630,177,14441,11471
2014,35,RICHMOND,1,CUNY,0,PUBLIC,1,4-Year/Grad,331800,800000041831,CITY UNIVERSITY OF NEW YORK COLLEGE OF STATEN ISLAND,10043,10019,24,3300,2923,377,0,0,193,808,10236,4108,2402,90,14344,11659.2
2015,35,RICHMOND,1,CUNY,0,PUBLIC,1,4-Year/Grad,331800,800000041831,CITY UNIVERSITY OF NEW YORK COLLEGE OF STATEN ISLAND,9717,9685,32,3006,2634,372,0,0,201,775,9918,3781,2453,118,13699,11230
2016,35,RICHMOND,1,CUNY,0,PUBLIC,1,4-Year/Grad,331800,800000041831,CITY UNIVERSITY OF NEW YORK COLLEGE OF STATEN ISLAND,9584,9567,17,2948,2556,392,0,0,203,784,9787,3732,2476,127,13519,11083.27
2017,35,RICHMOND,1,CUNY,0,PUBLIC,1,4-Year/Grad,331800,800000041831,CITY UNIVERSITY OF NEW YORK COLLEGE OF STATEN ISLAND,9710,9696,14,2799,2422,377,0,0,201,884,9911,3683,2584,145,13594,11197.6
2018,35,RICHMOND,1,CUNY,0,PUBLIC,1,4-Year/Grad,331800,800000041831,CITY UNIVERSITY OF NEW YORK COLLEGE OF STATEN ISLAND,9567,9544,23,2644,2271,373,0,0,224,812,9791,3456,2555,108,13247,10997.13
2019,35,RICHMOND,1,CUNY,0,PUBLIC,1,4-Year/Grad,331800,800000041831,CITY UNIVERSITY OF NEW YORK COLLEGE OF STATEN ISLAND,9124,9111,13,2576,2177,399,0,0,209,873,9333,3449,2290,71,12782,10540.87
2010,32,BRONX,1,CUNY,0,PUBLIC,1,4-Year/Grad,332000,800000046077,CITY UNIVERSITY OF NEW YORK HERBERT H. LEHMAN COLLEGE,5841,5808,33,4000,3002,998,0,0,298,1976,6139,5976,619,22,12115,8262.73
2011,32,BRONX,1,CUNY,0,PUBLIC,1,4-Year/Grad,332000,800000046077,CITY UNIVERSITY OF NEW YORK HERBERT H. LEHMAN COLLEGE,5784,5760,24,4079,3188,891,0,0,281,2143,6065,6222,608,18,12287,8281.87
2012,32,BRONX,1,CUNY,0,PUBLIC,1,4-Year/Grad,332000,800000046077,CITY UNIVERSITY OF NEW YORK HERBERT H. LEHMAN COLLEGE,5344,5323,21,4233,3530,703,0,0,242,2043,5586,6276,535,16,11862,7814.2
2013,32,BRONX,1,CUNY,0,PUBLIC,1,4-Year/Grad,332000,800000046077,CITY UNIVERSITY OF NEW YORK HERBERT H. LEHMAN COLLEGE,5643,5625,18,4243,3395,848,0,0,273,1926,5916,6169,582,6,12085,8100.73
2014,32,BRONX,1,CUNY,0,PUBLIC,1,4-Year/Grad,332000,800000046077,CITY UNIVERSITY OF NEW YORK HERBERT H. LEHMAN COLLEGE,5925,5864,61,4401,3553,848,0,0,283,1789,6208,6190,660,14,12398,8390.6
2015,32,BRONX,1,CUNY,0,PUBLIC,1,4-Year/Grad,332000,800000046077,CITY UNIVERSITY OF NEW YORK HERBERT H. LEHMAN COLLEGE,6259,6226,33,4541,3648,893,0,0,249,1758,6508,6299,610,22,12807,8724.87
2016,32,BRONX,1,CUNY,0,PUBLIC,1,4-Year/Grad,332000,800000046077,CITY UNIVERSITY OF NEW YORK HERBERT H. LEHMAN COLLEGE,6600,6575,25,4720,3736,984,0,0,234,1775,6834,6495,672,18,13329,9117.33
2017,32,BRONX,1,CUNY,0,PUBLIC,1,4-Year/Grad,332000,800000046077,CITY UNIVERSITY OF NEW YORK HERBERT H. LEHMAN COLLEGE,7216,7187,29,4762,3762,1000,0,0,227,1925,7443,6687,919,21,14130,9800.33
2018,32,BRONX,1,CUNY,0,PUBLIC,1,4-Year/Grad,332000,800000046077,CITY UNIVERSITY OF NEW YORK HERBERT H. LEHMAN COLLEGE,7794,7780,14,4845,3779,1066,0,0,214,1934,8008,6779,1012,20,14787,10396.6
2019,32,BRONX,1,CUNY,0,PUBLIC,1,4-Year/Grad,332000,800000046077,CITY UNIVERSITY OF NEW YORK HERBERT H. LEHMAN COLLEGE,8066,8049,17,4936,3748,1188,0,0,198,1943,8264,6879,933,9,15143,10686.53
2010,31,NEW YORK,1,CUNY,0,PUBLIC,1,4-Year/Grad,332500,800000047622,CUNY HUNTER COLLEGE,11023,10936,87,4661,3673,988,0,0,1380,5343,12403,10004,1740,48,22407,16093.87
2011,31,NEW YORK,1,CUNY,0,PUBLIC,1,4-Year/Grad,332500,800000047622,CUNY HUNTER COLLEGE,11548,11491,57,4797,3926,871,0,0,1427,5050,12975,9847,2130,47,22822,16594
2012,31,NEW YORK,1,CUNY,0,PUBLIC,1,4-Year/Grad,332500,800000047622,CUNY HUNTER COLLEGE,11956,11910,46,4752,3879,873,0,0,1385,4912,13341,9664,1924,47,23005,16889.8
2013,31,NEW YORK,1,CUNY,0,PUBLIC,1,4-Year/Grad,332500,800000047622,CUNY HUNTER COLLEGE,11747,11674,73,4942,4023,919,0,0,1340,4990,13087,9932,1921,55,23019,16730.33
2014,31,NEW YORK,1,CUNY,0,PUBLIC,1,4-Year/Grad,332500,800000047622,CUNY HUNTER COLLEGE,12142,12065,77,4737,3713,1024,0,0,1390,4843,13532,9580,2038,42,23112,17048.2
2015,31,NEW YORK,1,CUNY,0,PUBLIC,1,4-Year/Grad,332500,800000047622,CUNY HUNTER COLLEGE,12033,11942,91,4517,3523,994,0,0,1412,4956,13445,9473,2168,32,22918,16933.07
2016,31,NEW YORK,1,CUNY,0,PUBLIC,1,4-Year/Grad,332500,800000047622,CUNY HUNTER COLLEGE,12223,12164,59,4500,3468,1032,0,0,1474,4796,13697,9296,2193,15,22993,17115.4
2017,31,NEW YORK,1,CUNY,0,PUBLIC,1,4-Year/Grad,332500,800000047622,CUNY HUNTER COLLEGE,12612,12567,45,4232,3253,979,0,0,1536,4625,14148,8857,2330,7,23005,17408.67
2018,31,NEW YORK,1,CUNY,0,PUBLIC,1,4-Year/Grad,332500,800000047622,CUNY HUNTER COLLEGE,13111,13067,44,4101,3138,963,0,0,1505,4485,14616,8586,2589,9,23202,17777
2019,31,NEW YORK,1,CUNY,0,PUBLIC,1,4-Year/Grad,332500,800000047622,CUNY HUNTER COLLEGE,12991,12948,43,4130,3133,997,0,0,1689,4383,14680,8513,2526,21,23193,17809.87
2010,31,NEW YORK,1,CUNY,0,PUBLIC,1,4-Year/Grad,333000,800000047317,CITY UNIVERSITY OF NEW YORK JOHN JAY COLLEGE OF CRIMINAL JUSTICE,10035,10021,14,3243,2800,443,0,0,417,1511,10452,4754,1994,21,15206,12137.4
2011,31,NEW YORK,1,CUNY,0,PUBLIC,1,4-Year/Grad,333000,800000047317,CITY UNIVERSITY OF NEW YORK JOHN JAY COLLEGE OF CRIMINAL JUSTICE,9935,9931,4,2952,2506,446,0,0,424,1477,10359,4429,1745,21,14788,11933.8
2012,31,NEW YORK,1,CUNY,0,PUBLIC,1,4-Year/Grad,333000,800000047317,CITY UNIVERSITY OF NEW YORK JOHN JAY COLLEGE OF CRIMINAL JUSTICE,10286,10269,17,2881,2565,316,0,0,373,1456,10659,4337,1891,17,14996,12201.73
2013,31,NEW YORK,1,CUNY,0,PUBLIC,1,4-Year/Grad,333000,800000047317,CITY UNIVERSITY OF NEW YORK JOHN JAY COLLEGE OF CRIMINAL JUSTICE,10374,10370,4,2843,2468,375,0,0,390,1403,10764,4246,1850,11,15010,12272.87
2014,31,NEW YORK,1,CUNY,0,PUBLIC,1,4-Year/Grad,333000,800000047317,CITY UNIVERSITY OF NEW YORK JOHN JAY COLLEGE OF CRIMINAL JUSTICE,10225,10219,6,3080,2539,541,0,0,346,1394,10571,4474,1744,19,15045,12155.27
2015,31,NEW YORK,1,CUNY,0,PUBLIC,1,4-Year/Grad,333000,800000047317,CITY UNIVERSITY OF NEW YORK JOHN JAY COLLEGE OF CRIMINAL JUSTICE,10130,10126,4,2839,2419,420,0,0,385,1378,10515,4217,1479,10,14732,12012.53
2016,31,NEW YORK,1,CUNY,0,PUBLIC,1,4-Year/Grad,333000,800000047317,CITY UNIVERSITY OF NEW YORK JOHN JAY COLLEGE OF CRIMINAL JUSTICE,9831,9828,3,2843,2347,496,0,0,351,1405,10182,4248,1507,16,14430,11691.67
2017,31,NEW YORK,1,CUNY,0,PUBLIC,1,4-Year/Grad,333000,800000047317,CITY UNIVERSITY OF NEW YORK JOHN JAY COLLEGE OF CRIMINAL JUSTICE,10276,10272,4,2640,2154,486,0,0,403,1515,10679,4155,1831,13,14834,12165
2018,31,NEW YORK,1,CUNY,0,PUBLIC,1,4-Year/Grad,333000,800000047317,CITY UNIVERSITY OF NEW YORK JOHN JAY COLLEGE OF CRIMINAL JUSTICE,10740,10736,4,2579,2116,463,0,0,388,1687,11128,4266,1852,14,15394,12662.47
2019,31,NEW YORK,1,CUNY,0,PUBLIC,1,4-Year/Grad,333000,800000047317,CITY UNIVERSITY OF NEW YORK JOHN JAY COLLEGE OF CRIMINAL JUSTICE,11200,11193,7,2546,2097,449,0,0,430,1704,11630,4250,2023,33,15880,13160.27
2012,31,NEW YORK,1,CUNY,0,PUBLIC,0,2-Year,333500,800000073513,CUNY STELLA AND CHARLES GUTTMAN COMMUNITY COLLEGE,289,289,0,0,0,0,0,0,0,0,289,0,289,0,289,289
2013,31,NEW YORK,1,CUNY,0,PUBLIC,0,2-Year,333500,800000073513,CUNY STELLA AND CHARLES GUTTMAN COMMUNITY COLLEGE,485,485,0,11,11,0,0,0,0,0,485,11,275,0,496,488.67
2014,31,NEW YORK,1,CUNY,0,PUBLIC,0,2-Year,333500,800000073513,CUNY STELLA AND CHARLES GUTTMAN COMMUNITY COLLEGE,620,620,0,72,72,0,0,0,0,0,620,72,409,0,692,644
2015,31,NEW YORK,1,CUNY,0,PUBLIC,0,2-Year,333500,800000073513,CUNY STELLA AND CHARLES GUTTMAN COMMUNITY COLLEGE,743,743,0,80,80,0,0,0,0,0,743,80,442,1,823,769.67
2016,31,NEW YORK,1,CUNY,0,PUBLIC,0,2-Year,333500,800000073513,CUNY STELLA AND CHARLES GUTTMAN COMMUNITY COLLEGE,838,838,0,157,108,49,0,0,0,0,838,157,430,0,995,890.33
2017,31,NEW YORK,1,CUNY,0,PUBLIC,0,2-Year,333500,800000073513,CUNY STELLA AND CHARLES GUTTMAN COMMUNITY COLLEGE,903,903,0,163,107,56,0,0,0,0,903,163,460,0,1066,957.33
2018,31,NEW YORK,1,CUNY,0,PUBLIC,0,2-Year,333500,800000073513,CUNY STELLA AND CHARLES GUTTMAN COMMUNITY COLLEGE,848,834,14,107,107,0,0,0,0,0,848,107,455,0,955,883.67
2019,31,NEW YORK,1,CUNY,0,PUBLIC,0,2-Year,333500,800000073513,CUNY STELLA AND CHARLES GUTTMAN COMMUNITY COLLEGE,911,902,9,111,110,1,0,0,0,0,911,111,512,0,1022,948
2010,33,KINGS,1,CUNY,0,PUBLIC,1,4-Year/Grad,333800,800000045393,CUNY NYC COLLEGE OF TECHNOLOGY,9297,9280,17,6069,5223,846,0,0,0,0,9297,6069,2741,189,15366,11320
2011,33,KINGS,1,CUNY,0,PUBLIC,1,4-Year/Grad,333800,800000045393,CUNY NYC COLLEGE OF TECHNOLOGY,9856,9844,12,6105,5386,719,0,0,0,0,9856,6105,2951,176,15961,11891
2012,33,KINGS,1,CUNY,0,PUBLIC,1,4-Year/Grad,333800,800000045393,CUNY NYC COLLEGE OF TECHNOLOGY,10018,9945,73,6189,5358,831,0,0,0,0,10018,6189,2747,114,16207,12081
2013,33,KINGS,1,CUNY,0,PUBLIC,1,4-Year/Grad,333800,800000045393,CUNY NYC COLLEGE OF TECHNOLOGY,10318,10217,101,6542,5700,842,0,0,0,0,10318,6542,3119,234,16860,12498.67
2014,33,KINGS,1,CUNY,0,PUBLIC,1,4-Year/Grad,333800,800000045393,CUNY NYC COLLEGE OF TECHNOLOGY,10587,10482,105,6787,5872,915,0,0,0,0,10587,6787,3132,193,17374,12849.33
2015,33,KINGS,1,CUNY,0,PUBLIC,1,4-Year/Grad,333800,800000045393,CUNY NYC COLLEGE OF TECHNOLOGY,10821,10708,113,6603,5589,1014,0,0,0,0,10821,6603,3279,126,17424,13022
2016,33,KINGS,1,CUNY,0,PUBLIC,1,4-Year/Grad,333800,800000045393,CUNY NYC COLLEGE OF TECHNOLOGY,10912,10785,127,6370,5255,1115,0,0,0,0,10912,6370,3108,109,17282,13035.33
2017,33,KINGS,1,CUNY,0,PUBLIC,1,4-Year/Grad,333800,800000045393,CUNY NYC COLLEGE OF TECHNOLOGY,11030,10952,78,6249,5262,987,0,0,0,0,11030,6249,3107,137,17279,13113
2018,33,KINGS,1,CUNY,0,PUBLIC,1,4-Year/Grad,333800,800000045393,CUNY NYC COLLEGE OF TECHNOLOGY,10902,10847,55,6367,5357,1010,0,0,0,0,10902,6367,3223,179,17269,13024.33
2019,33,KINGS,1,CUNY,0,PUBLIC,1,4-Year/Grad,333800,800000045393,CUNY NYC COLLEGE OF TECHNOLOGY,10572,10514,58,6464,5379,1085,0,0,0,0,10572,6464,3199,267,17036,12726.67
2010,34,QUEENS,1,CUNY,0,PUBLIC,1,4-Year/Grad,334000,800000043093,CUNY QUEENS COLLEGE,11866,11853,13,4329,3484,845,0,0,533,4178,12399,8507,1471,20,20906,15513.2
2011,34,QUEENS,1,CUNY,0,PUBLIC,1,4-Year/Grad,334000,800000043093,CUNY QUEENS COLLEGE,11377,11265,112,5182,4184,998,0,0,452,3982,11829,9164,1419,25,20993,15149.13
2012,34,QUEENS,1,CUNY,0,PUBLIC,1,4-Year/Grad,334000,800000043093,CUNY QUEENS COLLEGE,11300,11279,21,4887,3978,909,0,0,415,3498,11715,8385,1427,22,20100,14743.2
2013,34,QUEENS,1,CUNY,0,PUBLIC,1,4-Year/Grad,334000,800000043093,CUNY QUEENS COLLEGE,10769,10755,14,4582,3669,913,0,0,480,3143,11249,7725,1350,14,18974,14033.53
2014,34,QUEENS,1,CUNY,0,PUBLIC,1,4-Year/Grad,334000,800000043093,CUNY QUEENS COLLEGE,11079,11061,18,4694,3781,913,0,0,482,3055,11561,7749,1514,30,19310,14347.67
2015,34,QUEENS,1,CUNY,0,PUBLIC,1,4-Year/Grad,334000,800000043093,CUNY QUEENS COLLEGE,11555,11509,46,4545,3639,906,0,0,441,2979,11996,7524,1536,11,19520,14702.6
2016,34,QUEENS,1,CUNY,0,PUBLIC,1,4-Year/Grad,334000,800000043093,CUNY QUEENS COLLEGE,11693,11654,39,4633,3772,861,0,0,468,2838,12161,7471,1453,28,19632,14840.53
2017,34,QUEENS,1,CUNY,0,PUBLIC,1,4-Year/Grad,334000,800000043093,CUNY QUEENS COLLEGE,12149,12096,53,4531,3666,865,0,0,443,2743,12592,7274,1639,33,19866,15199.53
2018,34,QUEENS,1,CUNY,0,PUBLIC,1,4-Year/Grad,334000,800000043093,CUNY QUEENS COLLEGE,12201,12141,60,4419,3504,915,0,0,430,2696,12631,7115,1936,17,19746,15182.4
2019,34,QUEENS,1,CUNY,0,PUBLIC,1,4-Year/Grad,334000,800000043093,CUNY QUEENS COLLEGE,12532,12489,43,4334,3418,916,0,0,394,2663,12926,6997,2246,20,19923,15435.87
2010,34,QUEENS,1,CUNY,0,PUBLIC,1,4-Year/Grad,335000,800000042570,CUNY YORK COLLEGE,4885,4878,7,2899,2144,755,0,0,37,0,4922,2899,1085,18,7821,5888.33
2011,34,QUEENS,1,CUNY,0,PUBLIC,1,4-Year/Grad,335000,800000042570,CUNY YORK COLLEGE,5121,5115,6,3089,2307,782,0,0,30,2,5151,3091,932,23,8242,6181.47
2012,34,QUEENS,1,CUNY,0,PUBLIC,1,4-Year/Grad,335000,800000042570,CUNY YORK COLLEGE,5357,5335,22,3024,2263,761,0,0,38,1,5395,3025,1089,22,8420,6403.4
2013,34,QUEENS,1,CUNY,0,PUBLIC,1,4-Year/Grad,335000,800000042570,CUNY YORK COLLEGE,5153,5104,49,3108,2257,851,0,0,46,0,5199,3108,955,39,8307,6235
2014,34,QUEENS,1,CUNY,0,PUBLIC,1,4-Year/Grad,335000,800000042570,CUNY YORK COLLEGE,5121,5069,52,3317,2176,1141,0,0,54,1,5175,3318,960,34,8493,6281.07
2015,34,QUEENS,1,CUNY,0,PUBLIC,1,4-Year/Grad,335000,800000042570,CUNY YORK COLLEGE,5226,5150,76,3220,2114,1106,0,0,65,0,5291,3220,995,35,8511,6364.33
2016,34,QUEENS,1,CUNY,0,PUBLIC,1,4-Year/Grad,335000,800000042570,CUNY YORK COLLEGE,5066,4997,69,3192,2143,1049,0,0,95,7,5161,3199,936,35,8360,6227.8
2017,34,QUEENS,1,CUNY,0,PUBLIC,1,4-Year/Grad,335000,800000042570,CUNY YORK COLLEGE,5056,4976,80,3337,2082,1255,0,0,126,14,5182,3351,1087,50,8533,6299.93
2018,34,QUEENS,1,CUNY,0,PUBLIC,1,4-Year/Grad,335000,800000042570,CUNY YORK COLLEGE,5085,5003,82,3410,2123,1287,0,0,147,51,5232,3461,1107,62,8693,6389.07
2019,34,QUEENS,1,CUNY,0,PUBLIC,1,4-Year/Grad,335000,800000042570,CUNY YORK COLLEGE,5113,5034,79,3003,1876,1127,0,0,164,57,5277,3060,1100,22,8337,6300.8
2010,31,NEW YORK,1,CUNY,0,PUBLIC,0,2-Year,370500,800000047605,BOROUGH OF MANHATTAN COMM COLLEGE,14658,14634,24,7876,7392,484,0,0,0,0,14658,7876,4425,751,22534,17283.33
2011,31,NEW YORK,1,CUNY,0,PUBLIC,0,2-Year,370500,800000047605,BOROUGH OF MANHATTAN COMM COLLEGE,15881,15867,14,8582,8021,561,0,0,0,0,15881,8582,5131,1139,24463,18741.67
2012,31,NEW YORK,1,CUNY,0,PUBLIC,0,2-Year,370500,800000047605,BOROUGH OF MANHATTAN COMM COLLEGE,16151,16128,23,8386,7836,550,0,0,0,0,16151,8386,4966,1090,24537,18946.33
2013,31,NEW YORK,1,CUNY,0,PUBLIC,0,2-Year,370500,800000047605,BOROUGH OF MANHATTAN COMM COLLEGE,15889,15872,17,8297,7786,511,0,0,0,0,15889,8297,4528,875,24186,18654.67
2014,31,NEW YORK,1,CUNY,0,PUBLIC,0,2-Year,370500,800000047605,BOROUGH OF MANHATTAN COMM COLLEGE,17131,17102,29,9475,8747,728,0,0,0,0,17131,9475,5551,1520,26606,20289.33
2015,31,NEW YORK,1,CUNY,0,PUBLIC,0,2-Year,370500,800000047605,BOROUGH OF MANHATTAN COMM COLLEGE,18074,18048,26,9235,8512,723,0,0,0,0,18074,9235,5532,1280,27309,21152.33
2016,31,NEW YORK,1,CUNY,0,PUBLIC,0,2-Year,370500,800000047605,BOROUGH OF MANHATTAN COMM COLLEGE,18189,18144,45,8559,7404,1155,0,0,0,0,18189,8559,5805,775,26748,21042
2017,31,NEW YORK,1,CUNY,0,PUBLIC,0,2-Year,370500,800000047605,BOROUGH OF MANHATTAN COMM COLLEGE,18479,18408,71,8453,7049,1404,0,0,0,0,18479,8453,5469,855,26932,21296.67
2018,31,NEW YORK,1,CUNY,0,PUBLIC,0,2-Year,370500,800000047605,BOROUGH OF MANHATTAN COMM COLLEGE,18076,18016,60,8430,7047,1383,0,0,0,0,18076,8430,5855,940,26506,20886
2019,31,NEW YORK,1,CUNY,0,PUBLIC,0,2-Year,370500,800000047605,BOROUGH OF MANHATTAN COMM COLLEGE,17772,17690,82,7728,6272,1456,0,0,0,0,17772,7728,5781,786,25500,20348
2010,32,BRONX,1,CUNY,0,PUBLIC,0,2-Year,371000,800000046078,BRONX COMMUNITY COLLEGE,6192,6188,4,4548,4159,389,0,0,0,0,6192,4548,1661,250,10740,7708
2011,32,BRONX,1,CUNY,0,PUBLIC,0,2-Year,371000,800000046078,BRONX COMMUNITY COLLEGE,6536,6531,5,4914,4212,702,0,0,0,0,6536,4914,1806,277,11450,8174
2012,32,BRONX,1,CUNY,0,PUBLIC,0,2-Year,371000,800000046078,BRONX COMMUNITY COLLEGE,6498,6491,7,4789,4107,682,0,0,0,0,6498,4789,1538,219,11287,8094.33
2013,32,BRONX,1,CUNY,0,PUBLIC,0,2-Year,371000,800000046078,BRONX COMMUNITY COLLEGE,6598,6590,8,4770,3987,783,0,0,0,0,6598,4770,1638,204,11368,8188
2014,32,BRONX,1,CUNY,0,PUBLIC,0,2-Year,371000,800000046078,BRONX COMMUNITY COLLEGE,6836,6830,6,4670,3855,815,0,0,0,0,6836,4670,1667,204,11506,8392.67
2015,32,BRONX,1,CUNY,0,PUBLIC,0,2-Year,371000,800000046078,BRONX COMMUNITY COLLEGE,6995,6990,5,4439,3493,946,0,0,0,0,6995,4439,1769,236,11434,8474.67
2016,32,BRONX,1,CUNY,0,PUBLIC,0,2-Year,371000,800000046078,BRONX COMMUNITY COLLEGE,6968,6963,5,3951,3297,654,0,0,0,0,6968,3951,1751,181,10919,8285
2017,32,BRONX,1,CUNY,0,PUBLIC,0,2-Year,371000,800000046078,BRONX COMMUNITY COLLEGE,7146,7144,2,3789,3026,763,0,0,0,0,7146,3789,1917,138,10935,8409
2018,32,BRONX,1,CUNY,0,PUBLIC,0,2-Year,371000,800000046078,BRONX COMMUNITY COLLEGE,6685,6681,4,3834,2852,982,0,0,0,0,6685,3834,1851,157,10519,7963
2019,32,BRONX,1,CUNY,0,PUBLIC,0,2-Year,371000,800000046078,BRONX COMMUNITY COLLEGE,6191,6176,15,3849,2731,1118,0,0,0,0,6191,3849,1780,209,10040,7474
2010,32,BRONX,1,CUNY,0,PUBLIC,0,2-Year,371500,800000046545,EUGENIO MARIA DE HOSTOS COMM COLLEGE,3768,3738,30,2731,2112,619,0,0,0,0,3768,2731,1020,53,6499,4678.33
2011,32,BRONX,1,CUNY,0,PUBLIC,0,2-Year,371500,800000046545,EUGENIO MARIA DE HOSTOS COMM COLLEGE,4179,4146,33,2899,2334,565,0,0,0,0,4179,2899,1135,95,7078,5145.33
2012,32,BRONX,1,CUNY,0,PUBLIC,0,2-Year,371500,800000046545,EUGENIO MARIA DE HOSTOS COMM COLLEGE,3567,3543,24,2888,2249,639,0,0,0,0,3567,2888,827,100,6455,4529.67
2013,32,BRONX,1,CUNY,0,PUBLIC,0,2-Year,371500,800000046545,EUGENIO MARIA DE HOSTOS COMM COLLEGE,4026,4003,23,2980,2435,545,0,0,0,0,4026,2980,1118,119,7006,5019.33
2014,32,BRONX,1,CUNY,0,PUBLIC,0,2-Year,371500,800000046545,EUGENIO MARIA DE HOSTOS COMM COLLEGE,4067,4040,27,2918,2349,569,0,0,0,0,4067,2918,924,96,6985,5039.67
2015,32,BRONX,1,CUNY,0,PUBLIC,0,2-Year,371500,800000046545,EUGENIO MARIA DE HOSTOS COMM COLLEGE,4192,4146,46,3179,2576,603,0,0,0,0,4192,3179,987,150,7371,5251.67
2016,32,BRONX,1,CUNY,0,PUBLIC,0,2-Year,371500,800000046545,EUGENIO MARIA DE HOSTOS COMM COLLEGE,4094,4045,49,3116,2461,655,0,0,0,0,4094,3116,913,128,7210,5132.67
2017,32,BRONX,1,CUNY,0,PUBLIC,0,2-Year,371500,800000046545,EUGENIO MARIA DE HOSTOS COMM COLLEGE,4165,4092,73,3046,2448,598,0,0,0,0,4165,3046,1040,156,7211,5180.33
2018,32,BRONX,1,CUNY,0,PUBLIC,0,2-Year,371500,800000046545,EUGENIO MARIA DE HOSTOS COMM COLLEGE,4138,4063,75,3193,2500,693,0,0,0,0,4138,3193,1154,156,7331,5202.33
2019,32,BRONX,1,CUNY,0,PUBLIC,0,2-Year,371500,800000046545,EUGENIO MARIA DE HOSTOS COMM COLLEGE,3758,3676,82,3362,2616,746,0,0,0,0,3758,3362,1088,158,7120,4878.67
2010,34,QUEENS,1,CUNY,0,PUBLIC,0,2-Year,372000,800000042215,FIORELLO H. LA GUARDIA COMM COLLEGE,10095,9940,155,7340,5586,1754,0,0,0,0,10095,7340,2880,358,17435,12541.67
2011,34,QUEENS,1,CUNY,0,PUBLIC,0,2-Year,372000,800000042215,FIORELLO H. LA GUARDIA COMM COLLEGE,10366,10234,132,8257,6007,2250,0,0,0,0,10366,8257,2665,510,18623,13118.33
2012,34,QUEENS,1,CUNY,0,PUBLIC,0,2-Year,372000,800000042215,FIORELLO H. LA GUARDIA COMM COLLEGE,9927,9798,129,8143,5837,2306,0,0,0,0,9927,8143,2725,555,18070,12641.33
2013,34,QUEENS,1,CUNY,0,PUBLIC,0,2-Year,372000,800000042215,FIORELLO H. LA GUARDIA COMM COLLEGE,10455,10360,95,9109,6461,2648,0,0,0,0,10455,9109,2530,478,19564,13491.33
2014,34,QUEENS,1,CUNY,0,PUBLIC,0,2-Year,372000,800000042215,FIORELLO H. LA GUARDIA COMM COLLEGE,11054,10905,149,9099,6234,2865,0,0,0,0,11054,9099,2697,389,20153,14087
2015,34,QUEENS,1,CUNY,0,PUBLIC,0,2-Year,372000,800000042215,FIORELLO H. LA GUARDIA COMM COLLEGE,10642,10505,137,8690,5557,3133,0,0,0,0,10642,8690,2600,328,19332,13538.67
2016,34,QUEENS,1,CUNY,0,PUBLIC,0,2-Year,372000,800000042215,FIORELLO H. LA GUARDIA COMM COLLEGE,10651,10523,128,8805,5634,3171,0,0,0,0,10651,8805,2654,440,19456,13586
2017,34,QUEENS,1,CUNY,0,PUBLIC,0,2-Year,372000,800000042215,FIORELLO H. LA GUARDIA COMM COLLEGE,10838,10633,205,8535,5110,3425,0,0,0,0,10838,8535,2576,373,19373,13683
2018,34,QUEENS,1,CUNY,0,PUBLIC,0,2-Year,372000,800000042215,FIORELLO H. LA GUARDIA COMM COLLEGE,10671,10431,240,8629,5161,3468,0,0,0,0,10671,8629,2348,307,19300,13547.33
2019,34,QUEENS,1,CUNY,0,PUBLIC,0,2-Year,372000,800000042215,FIORELLO H. LA GUARDIA COMM COLLEGE,9972,9705,267,8583,5118,3465,0,0,0,0,9972,8583,2625,344,18555,12833
2010,33,KINGS,1,CUNY,0,PUBLIC,0,2-Year,372500,800000043756,KINGSBOROUGH COMMUNITY COLLEGE,9709,9685,24,8714,5014,3700,0,0,0,0,9709,8714,2524,383,18423,12613.67
2011,33,KINGS,1,CUNY,0,PUBLIC,0,2-Year,372500,800000043756,KINGSBOROUGH COMMUNITY COLLEGE,11205,11167,38,8056,3824,4232,0,0,0,0,11205,8056,2547,155,19261,13890.33
2012,33,KINGS,1,CUNY,0,PUBLIC,0,2-Year,372500,800000043756,KINGSBOROUGH COMMUNITY COLLEGE,10348,10272,76,8058,4667,3391,0,0,0,0,10348,8058,2337,389,18406,13034
2013,33,KINGS,1,CUNY,0,PUBLIC,0,2-Year,372500,800000043756,KINGSBOROUGH COMMUNITY COLLEGE,10179,10091,88,9047,4382,4665,0,0,0,0,10179,9047,2425,265,19226,13194.67
2014,33,KINGS,1,CUNY,0,PUBLIC,0,2-Year,372500,800000043756,KINGSBOROUGH COMMUNITY COLLEGE,10201,10107,94,7224,3525,3699,0,0,0,0,10201,7224,2455,92,17425,12609
2015,33,KINGS,1,CUNY,0,PUBLIC,0,2-Year,372500,800000043756,KINGSBOROUGH COMMUNITY COLLEGE,9706,9611,95,7080,3245,3835,0,0,0,0,9706,7080,2266,88,16786,12066
2016,33,KINGS,1,CUNY,0,PUBLIC,0,2-Year,372500,800000043756,KINGSBOROUGH COMMUNITY COLLEGE,8860,8698,162,7108,3004,4104,0,0,0,0,8860,7108,2019,94,15968,11229.33
2017,33,KINGS,1,CUNY,0,PUBLIC,0,2-Year,372500,800000043756,KINGSBOROUGH COMMUNITY COLLEGE,8288,8130,158,6746,2785,3961,0,0,0,0,8288,6746,1848,120,15034,10536.67
2018,33,KINGS,1,CUNY,0,PUBLIC,0,2-Year,372500,800000043756,KINGSBOROUGH COMMUNITY COLLEGE,8154,7967,187,6897,2539,4358,0,0,0,0,8154,6897,1989,88,15051,10453
2019,33,KINGS,1,CUNY,0,PUBLIC,0,2-Year,372500,800000043756,KINGSBOROUGH COMMUNITY COLLEGE,7672,7458,214,7771,2478,5293,0,0,0,0,7672,7771,1945,184,15443,10262.33
2010,33,KINGS,1,CUNY,0,PUBLIC,1,4-Year/Grad,372800,800000044737,MEDGAR EVERS COLLEGE,4542,4537,5,2378,1977,401,0,0,0,0,4542,2378,1127,61,6920,5334.67
2011,33,KINGS,1,CUNY,0,PUBLIC,1,4-Year/Grad,372800,800000044737,MEDGAR EVERS COLLEGE,4561,4544,17,2405,2038,367,0,0,0,0,4561,2405,1126,75,6966,5362.67
2012,33,KINGS,1,CUNY,0,PUBLIC,1,4-Year/Grad,372800,800000044737,MEDGAR EVERS COLLEGE,4154,4140,14,2386,2079,307,0,0,0,0,4154,2386,988,57,6540,4949.33
2013,33,KINGS,1,CUNY,0,PUBLIC,1,4-Year/Grad,372800,800000044737,MEDGAR EVERS COLLEGE,4267,4200,67,2210,1885,325,0,0,0,0,4267,2210,993,52,6477,5003.67
2014,33,KINGS,1,CUNY,0,PUBLIC,1,4-Year/Grad,372800,800000044737,MEDGAR EVERS COLLEGE,4324,4244,80,2377,1997,380,0,0,0,0,4324,2377,981,119,6701,5116.33
2015,33,KINGS,1,CUNY,0,PUBLIC,1,4-Year/Grad,372800,800000044737,MEDGAR EVERS COLLEGE,4513,4366,147,2252,1891,361,0,0,0,0,4513,2252,1013,79,6765,5263.67
2016,33,KINGS,1,CUNY,0,PUBLIC,1,4-Year/Grad,372800,800000044737,MEDGAR EVERS COLLEGE,4760,4664,96,2059,1741,318,0,0,0,0,4760,2059,1101,42,6819,5446.33
2017,33,KINGS,1,CUNY,0,PUBLIC,1,4-Year/Grad,372800,800000044737,MEDGAR EVERS COLLEGE,4806,4741,65,1846,1463,383,0,0,0,0,4806,1846,1144,45,6652,5421.33
2018,33,KINGS,1,CUNY,0,PUBLIC,1,4-Year/Grad,372800,800000044737,MEDGAR EVERS COLLEGE,4705,4616,89,1933,1303,630,0,0,0,0,4705,1933,1148,39,6638,5349.33
2019,33,KINGS,1,CUNY,0,PUBLIC,1,4-Year/Grad,372800,800000044737,MEDGAR EVERS COLLEGE,4118,4024,94,1680,1289,391,0,0,0,0,4118,1680,857,29,5798,4678
2010,34,QUEENS,1,CUNY,0,PUBLIC,0,2-Year,373500,800000042990,QUEENSBOROUGH COMMUNITY COLLEGE,9276,9197,79,6040,4574,1466,0,0,0,0,9276,6040,2912,297,15316,11289.33
2011,34,QUEENS,1,CUNY,0,PUBLIC,0,2-Year,373500,800000042990,QUEENSBOROUGH COMMUNITY COLLEGE,9580,9515,65,7257,5632,1625,0,0,0,0,9580,7257,3326,608,16837,11999
2012,34,QUEENS,1,CUNY,0,PUBLIC,0,2-Year,373500,800000042990,QUEENSBOROUGH COMMUNITY COLLEGE,9383,9326,57,6328,4766,1562,0,0,0,0,9383,6328,3050,285,15711,11492.33
2013,34,QUEENS,1,CUNY,0,PUBLIC,0,2-Year,373500,800000042990,QUEENSBOROUGH COMMUNITY COLLEGE,9626,9585,41,6665,4769,1896,0,0,0,0,9626,6665,3055,341,16291,11847.67
2014,34,QUEENS,1,CUNY,0,PUBLIC,0,2-Year,373500,800000042990,QUEENSBOROUGH COMMUNITY COLLEGE,9551,9524,27,6631,4673,1958,0,0,0,0,9551,6631,3057,335,16182,11761.33
2015,34,QUEENS,1,CUNY,0,PUBLIC,0,2-Year,373500,800000042990,QUEENSBOROUGH COMMUNITY COLLEGE,9290,9252,38,6203,4440,1763,0,0,0,0,9290,6203,3063,291,15493,11357.67
2016,34,QUEENS,1,CUNY,0,PUBLIC,0,2-Year,373500,800000042990,QUEENSBOROUGH COMMUNITY COLLEGE,9105,9075,30,6464,4521,1943,0,0,0,0,9105,6464,2998,318,15569,11259.67
2017,34,QUEENS,1,CUNY,0,PUBLIC,0,2-Year,373500,800000042990,QUEENSBOROUGH COMMUNITY COLLEGE,9208,9145,63,6192,4196,1996,0,0,0,0,9208,6192,2880,266,15400,11272
2018,34,QUEENS,1,CUNY,0,PUBLIC,0,2-Year,373500,800000042990,QUEENSBOROUGH COMMUNITY COLLEGE,9232,9116,116,6179,3985,2194,0,0,0,0,9232,6179,2985,227,15411,11291.67
2019,34,QUEENS,1,CUNY,0,PUBLIC,0,2-Year,373500,800000042990,QUEENSBOROUGH COMMUNITY COLLEGE,8411,8342,69,5624,4111,1513,0,0,0,0,8411,5624,2908,295,14035,10285.67
2010,34,QUEENS,2,INDEPENDENT,1,PRIVATE,1,4-Year/Grad,400500,800000043086,VAUGHN COLLEGE OF AERONAUTICS AND TECHNOLOGY,1113,1113,0,374,372,2,0,0,4,18,1117,392,234,23,1509,1248.87
2011,34,QUEENS,2,INDEPENDENT,1,PRIVATE,1,4-Year/Grad,400500,800000043086,VAUGHN COLLEGE OF AERONAUTICS AND TECHNOLOGY,1299,1299,0,379,373,6,0,0,2,16,1301,395,300,15,1696,1433.73
2012,34,QUEENS,2,INDEPENDENT,1,PRIVATE,1,4-Year/Grad,400500,800000043086,VAUGHN COLLEGE OF AERONAUTICS AND TECHNOLOGY,1362,1361,1,437,435,2,0,0,3,10,1365,447,299,22,1812,1514.67
2013,34,QUEENS,2,INDEPENDENT,1,PRIVATE,1,4-Year/Grad,400500,800000043086,VAUGHN COLLEGE OF AERONAUTICS AND TECHNOLOGY,1308,1308,0,417,414,3,0,0,0,17,1308,434,307,7,1742,1453.8
2014,34,QUEENS,2,INDEPENDENT,1,PRIVATE,1,4-Year/Grad,400500,800000043086,VAUGHN COLLEGE OF AERONAUTICS AND TECHNOLOGY,1361,1361,0,295,295,0,0,0,2,7,1363,302,270,2,1665,1464.13
2015,34,QUEENS,2,INDEPENDENT,1,PRIVATE,1,4-Year/Grad,400500,800000043086,VAUGHN COLLEGE OF AERONAUTICS AND TECHNOLOGY,1304,1300,4,234,231,3,0,0,1,7,1305,241,254,18,1546,1385.8
2016,34,QUEENS,2,INDEPENDENT,1,PRIVATE,1,4-Year/Grad,400500,800000043086,VAUGHN COLLEGE OF AERONAUTICS AND TECHNOLOGY,1275,1275,0,265,265,0,0,0,1,4,1276,269,261,17,1545,1365.93
2017,34,QUEENS,2,INDEPENDENT,1,PRIVATE,1,4-Year/Grad,400500,800000043086,VAUGHN COLLEGE OF AERONAUTICS AND TECHNOLOGY,1228,1228,0,268,268,0,0,0,1,4,1229,272,243,10,1501,1319.93
2018,34,QUEENS,2,INDEPENDENT,1,PRIVATE,1,4-Year/Grad,400500,800000043086,VAUGHN COLLEGE OF AERONAUTICS AND TECHNOLOGY,1302,1302,0,268,266,2,0,0,3,5,1305,273,304,9,1578,1396.33
2019,34,QUEENS,2,INDEPENDENT,1,PRIVATE,1,4-Year/Grad,400500,800000043086,VAUGHN COLLEGE OF AERONAUTICS AND TECHNOLOGY,1322,1322,0,317,314,3,0,0,5,1,1327,318,325,10,1645,1433.07
2010,28,NASSAU,2,INDEPENDENT,1,PRIVATE,1,4-Year/Grad,401000,800000049414,ADELPHI UNIVERSITY,4335,4332,3,604,585,19,0,0,1042,1936,5377,2540,909,12,7917,6352.73
2011,28,NASSAU,2,INDEPENDENT,1,PRIVATE,1,4-Year/Grad,401000,800000049414,ADELPHI UNIVERSITY,4474,4473,1,547,533,14,0,0,1627,1274,6101,1821,979,9,7922,6792.93
2012,28,NASSAU,2,INDEPENDENT,1,PRIVATE,1,4-Year/Grad,401000,800000049414,ADELPHI UNIVERSITY,4525,4524,1,790,529,261,0,0,1629,1127,6154,1917,996,3,8071,6868.13
2013,28,NASSAU,2,INDEPENDENT,1,PRIVATE,1,4-Year/Grad,401000,800000049414,ADELPHI UNIVERSITY,4531,4524,7,1662,476,1186,0,0,1503,1102,6034,2764,903,15,8798,7028.8
2014,28,NASSAU,2,INDEPENDENT,1,PRIVATE,1,4-Year/Grad,401000,800000049414,ADELPHI UNIVERSITY,4589,4576,13,1612,460,1152,0,0,1407,1132,5996,2744,954,21,8740,6986.13
2015,28,NASSAU,2,INDEPENDENT,1,PRIVATE,1,4-Year/Grad,401000,800000049414,ADELPHI UNIVERSITY,4414,4400,14,1553,413,1140,0,0,1263,1141,5677,2694,854,14,8371,6651.07
2016,28,NASSAU,2,INDEPENDENT,1,PRIVATE,1,4-Year/Grad,401000,800000049414,ADELPHI UNIVERSITY,4742,4737,5,636,398,238,0,0,1266,1216,6008,1852,1215,11,7860,6706.4
2017,28,NASSAU,2,INDEPENDENT,1,PRIVATE,1,4-Year/Grad,401000,800000049414,ADELPHI UNIVERSITY,4874,4858,16,576,304,272,0,0,1455,1257,6329,1833,1121,10,8162,7023.8
2018,28,NASSAU,2,INDEPENDENT,1,PRIVATE,1,4-Year/Grad,401000,800000049414,ADELPHI UNIVERSITY,5056,5043,13,540,264,276,0,0,1506,1249,6562,1789,1237,8,8351,7241.6
2019,28,NASSAU,2,INDEPENDENT,1,PRIVATE,1,4-Year/Grad,401000,800000049414,ADELPHI UNIVERSITY,5063,5050,13,297,225,72,20,15,1430,1166,6513,1478,1124,8,7991,7084.4
2010,01,ALBANY,2,INDEPENDENT,1,PRIVATE,1,4-Year/Grad,401500,800000055588,ALBANY COLLEGE OF PHARMACY AND HEALTH SCIENCES,966,966,0,19,19,0,447,0,20,2,1433,21,220,0,1454,1440.13
2011,01,ALBANY,2,INDEPENDENT,1,PRIVATE,1,4-Year/Grad,401500,800000055588,ALBANY COLLEGE OF PHARMACY AND HEALTH SCIENCES,932,932,0,20,18,2,425,0,47,16,1404,36,212,0,1440,1417.07
2012,01,ALBANY,2,INDEPENDENT,1,PRIVATE,1,4-Year/Grad,401500,800000055588,ALBANY COLLEGE OF PHARMACY AND HEALTH SCIENCES,938,938,0,12,9,3,420,1,55,14,1413,27,247,0,1440,1423
2013,01,ALBANY,2,INDEPENDENT,1,PRIVATE,1,4-Year/Grad,401500,800000055588,ALBANY COLLEGE OF PHARMACY AND HEALTH SCIENCES,953,951,2,19,18,1,392,0,46,0,1391,19,243,1,1410,1397.33
2014,01,ALBANY,2,INDEPENDENT,1,PRIVATE,1,4-Year/Grad,401500,800000055588,ALBANY COLLEGE OF PHARMACY AND HEALTH SCIENCES,962,960,2,23,21,2,334,0,30,4,1326,27,213,0,1353,1335.27
2015,01,ALBANY,2,INDEPENDENT,1,PRIVATE,1,4-Year/Grad,401500,800000055588,ALBANY COLLEGE OF PHARMACY AND HEALTH SCIENCES,995,993,2,10,9,1,439,0,31,8,1465,18,188,0,1483,1471.53
2016,01,ALBANY,2,INDEPENDENT,1,PRIVATE,1,4-Year/Grad,401500,800000055588,ALBANY COLLEGE OF PHARMACY AND HEALTH SCIENCES,827,827,0,5,4,1,371,2,37,5,1235,12,153,1,1247,1239.47
2017,01,ALBANY,2,INDEPENDENT,1,PRIVATE,1,4-Year/Grad,401500,800000055588,ALBANY COLLEGE OF PHARMACY AND HEALTH SCIENCES,812,812,0,7,4,3,371,0,42,0,1225,7,185,1,1232,1227.33
2018,01,ALBANY,2,INDEPENDENT,1,PRIVATE,1,4-Year/Grad,401500,800000055588,ALBANY COLLEGE OF PHARMACY AND HEALTH SCIENCES,795,795,0,5,3,2,356,2,39,3,1190,10,191,0,1200,1193.67
2019,01,ALBANY,2,INDEPENDENT,1,PRIVATE,1,4-Year/Grad,401500,800000055588,ALBANY COLLEGE OF PHARMACY AND HEALTH SCIENCES,736,736,0,9,3,6,332,2,28,10,1096,21,185,0,1117,1103.8
2010,01,ALBANY,2,INDEPENDENT,1,PRIVATE,1,4-Year/Grad,402000,800000055587,ALBANY LAW SCHOOL,0,0,0,0,0,0,696,27,5,5,701,32,0,0,733,713.8
2011,01,ALBANY,2,INDEPENDENT,1,PRIVATE,1,4-Year/Grad,402000,800000055587,ALBANY LAW SCHOOL,0,0,0,0,0,0,669,16,2,2,671,18,0,0,689,678.2
2012,01,ALBANY,2,INDEPENDENT,1,PRIVATE,1,4-Year/Grad,402000,800000055587,ALBANY LAW SCHOOL,0,0,0,0,0,0,564,41,2,5,566,46,0,0,612,584.4
2013,01,ALBANY,2,INDEPENDENT,1,PRIVATE,1,4-Year/Grad,402000,800000055587,ALBANY LAW SCHOOL,0,0,0,0,0,0,545,46,2,7,547,53,0,0,600,568.2
2014,01,ALBANY,2,INDEPENDENT,1,PRIVATE,1,4-Year/Grad,402000,800000055587,ALBANY LAW SCHOOL,0,0,0,0,0,0,417,52,0,0,417,52,0,0,469,437.8
2015,01,ALBANY,2,INDEPENDENT,1,PRIVATE,1,4-Year/Grad,402000,800000055587,ALBANY LAW SCHOOL,0,0,0,0,0,0,364,39,3,8,367,47,0,0,414,385.8
2016,01,ALBANY,2,INDEPENDENT,1,PRIVATE,1,4-Year/Grad,402000,800000055587,ALBANY LAW SCHOOL,0,0,0,0,0,0,342,38,0,14,342,52,0,0,394,362.8
2017,01,ALBANY,2,INDEPENDENT,1,PRIVATE,1,4-Year/Grad,402000,800000055587,ALBANY LAW SCHOOL,0,0,0,0,0,0,372,35,3,25,375,60,0,0,435,399
2018,01,ALBANY,2,INDEPENDENT,1,PRIVATE,1,4-Year/Grad,402000,800000055587,ALBANY LAW SCHOOL,0,0,0,0,0,0,443,22,17,23,460,45,0,0,505,478
2019,01,ALBANY,2,INDEPENDENT,1,PRIVATE,1,4-Year/Grad,402000,800000055587,ALBANY LAW SCHOOL,0,0,0,0,0,0,16,471,17,30,33,501,0,0,534,233.4
2010,01,ALBANY,2,INDEPENDENT,1,PRIVATE,1,4-Year/Grad,402500,800000055589,ALBANY MEDICAL COLLEGE,0,0,0,0,0,0,573,0,242,0,815,0,0,0,815,815
2011,01,ALBANY,2,INDEPENDENT,1,PRIVATE,1,4-Year/Grad,402500,800000055589,ALBANY MEDICAL COLLEGE,0,0,0,0,0,0,570,0,246,0,816,0,0,0,816,816
2012,01,ALBANY,2,INDEPENDENT,1,PRIVATE,1,4-Year/Grad,402500,800000055589,ALBANY MEDICAL COLLEGE,0,0,0,0,0,0,571,0,269,0,840,0,0,0,840,840
2013,01,ALBANY,2,INDEPENDENT,1,PRIVATE,1,4-Year/Grad,402500,800000055589,ALBANY MEDICAL COLLEGE,0,0,0,0,0,0,558,0,272,0,830,0,0,0,830,830
2014,01,ALBANY,2,INDEPENDENT,1,PRIVATE,1,4-Year/Grad,402500,800000055589,ALBANY MEDICAL COLLEGE,0,0,0,0,0,0,558,0,265,0,823,0,0,0,823,823
2015,01,ALBANY,2,INDEPENDENT,1,PRIVATE,1,4-Year/Grad,402500,800000055589,ALBANY MEDICAL COLLEGE,0,0,0,0,0,0,575,0,247,0,822,0,0,0,822,822
2016,01,ALBANY,2,INDEPENDENT,1,PRIVATE,1,4-Year/Grad,402500,800000055589,ALBANY MEDICAL COLLEGE,0,0,0,0,0,0,575,0,247,0,822,0,0,0,822,822
2017,01,ALBANY,2,INDEPENDENT,1,PRIVATE,1,4-Year/Grad,402500,800000055589,ALBANY MEDICAL COLLEGE,0,0,0,0,0,0,590,0,250,0,840,0,0,0,840,840
2018,01,ALBANY,2,INDEPENDENT,1,PRIVATE,1,4-Year/Grad,402500,800000055589,ALBANY MEDICAL COLLEGE,0,0,0,0,0,0,578,0,250,0,828,0,0,0,828,828
2019,01,ALBANY,2,INDEPENDENT,1,PRIVATE,1,4-Year/Grad,402500,800000055589,ALBANY MEDICAL COLLEGE,0,0,0,0,0,0,569,0,259,0,828,0,0,0,828,828
2019,32,BRONX,2,INDEPENDENT,1,PRIVATE,1,4-Year/Grad,402510,800000091563,ALBERT EINSTEIN COLLEGE OF MEDICINE,0,0,0,0,0,0,765,0,197,0,962,0,0,0,962,962
2014,66,WESTCHESTER,2,INDEPENDENT,1,PRIVATE,1,4-Year/Grad,402600,800000083023,ACADEMY FOR JEWISH RELIGION,0,0,0,0,0,0,0,0,17,21,17,21,0,0,38,25.4
2015,66,WESTCHESTER,2,INDEPENDENT,1,PRIVATE,1,4-Year/Grad,402600,800000083023,ACADEMY FOR JEWISH RELIGION,0,0,0,0,0,0,0,0,12,26,12,26,0,0,38,22.4
2016,66,WESTCHESTER,2,INDEPENDENT,1,PRIVATE,1,4-Year/Grad,402600,800000083023,ACADEMY FOR JEWISH RELIGION,0,0,0,0,0,0,3,9,9,12,12,21,0,0,33,20.4
2010,02,ALLEGANY,2,INDEPENDENT,1,PRIVATE,1,4-Year/Grad,403000,800000055241,ALFRED UNIVERSITY,1229,1218,11,30,12,18,0,0,104,215,1333,245,379,1,1578,1429
2011,02,ALLEGANY,2,INDEPENDENT,1,PRIVATE,1,4-Year/Grad,403000,800000055241,ALFRED UNIVERSITY,1263,1256,7,42,15,27,0,0,115,240,1378,282,420,1,1660,1488
2012,02,ALLEGANY,2,INDEPENDENT,1,PRIVATE,1,4-Year/Grad,403000,800000055241,ALFRED UNIVERSITY,1274,1256,18,39,11,28,0,0,125,223,1399,262,398,0,1661,1501.2
2013,02,ALLEGANY,2,INDEPENDENT,1,PRIVATE,1,4-Year/Grad,403000,800000055241,ALFRED UNIVERSITY,1309,1294,15,33,8,25,0,0,99,280,1408,313,405,0,1721,1531
2014,02,ALLEGANY,2,INDEPENDENT,1,PRIVATE,1,4-Year/Grad,403000,800000055241,ALFRED UNIVERSITY,1292,1273,19,94,20,74,0,0,98,205,1390,299,369,0,1689,1503.33
2015,02,ALLEGANY,2,INDEPENDENT,1,PRIVATE,1,4-Year/Grad,403000,800000055241,ALFRED UNIVERSITY,1208,1193,15,32,14,18,0,0,124,269,1332,301,316,0,1633,1450.27
2016,02,ALLEGANY,2,INDEPENDENT,1,PRIVATE,1,4-Year/Grad,403000,800000055241,ALFRED UNIVERSITY,1223,1216,7,82,17,65,0,0,113,394,1336,476,327,0,1812,1520.93
2017,02,ALLEGANY,2,INDEPENDENT,1,PRIVATE,1,4-Year/Grad,403000,800000055241,ALFRED UNIVERSITY,1119,1118,1,107,35,72,0,0,129,458,1248,565,294,0,1813,1466.87
2018,02,ALLEGANY,2,INDEPENDENT,1,PRIVATE,1,4-Year/Grad,403000,800000055241,ALFRED UNIVERSITY,1055,1053,2,24,16,8,0,0,81,470,1136,494,312,0,1630,1332
2019,02,ALLEGANY,2,INDEPENDENT,1,PRIVATE,1,4-Year/Grad,403000,800000055241,ALFRED UNIVERSITY,1162,1157,5,56,19,37,0,0,95,491,1257,547,344,0,1804,1472.07
2010,31,NEW YORK,2,INDEPENDENT,1,PRIVATE,0,2-Year,403500,800000047613,AMER ACADEMY OF DRAMATIC ARTS,233,233,0,0,0,0,0,0,0,0,233,0,72,0,233,233
2011,31,NEW YORK,2,INDEPENDENT,1,PRIVATE,0,2-Year,403500,800000047613,AMER ACADEMY OF DRAMATIC ARTS,240,240,0,0,0,0,0,0,0,0,240,0,78,0,240,240
2012,31,NEW YORK,2,INDEPENDENT,1,PRIVATE,0,2-Year,403500,800000047613,AMER ACADEMY OF DRAMATIC ARTS,222,222,0,0,0,0,0,0,0,0,222,0,61,0,222,222
2013,31,NEW YORK,2,INDEPENDENT,1,PRIVATE,0,2-Year,403500,800000047613,AMER ACADEMY OF DRAMATIC ARTS,253,253,0,0,0,0,0,0,0,0,253,0,100,0,253,253
2014,31,NEW YORK,2,INDEPENDENT,1,PRIVATE,0,2-Year,403500,800000047613,AMER ACADEMY OF DRAMATIC ARTS,290,290,0,0,0,0,0,0,0,0,290,0,103,0,290,290
2015,31,NEW YORK,2,INDEPENDENT,1,PRIVATE,0,2-Year,403500,800000047613,AMER ACADEMY OF DRAMATIC ARTS,304,304,0,0,0,0,0,0,0,0,304,0,135,0,304,304
2016,31,NEW YORK,2,INDEPENDENT,1,PRIVATE,0,2-Year,403500,800000047613,AMER ACADEMY OF DRAMATIC ARTS,311,311,0,0,0,0,0,0,0,0,311,0,126,0,311,311
2017,31,NEW YORK,2,INDEPENDENT,1,PRIVATE,0,2-Year,403500,800000047613,AMER ACADEMY OF DRAMATIC ARTS,326,326,0,0,0,0,0,0,0,0,326,0,127,0,326,326
2018,31,NEW YORK,2,INDEPENDENT,1,PRIVATE,0,2-Year,403500,800000047613,AMER ACADEMY OF DRAMATIC ARTS,294,294,0,0,0,0,0,0,0,0,294,0,92,0,294,294
2019,31,NEW YORK,2,INDEPENDENT,1,PRIVATE,0,2-Year,403500,800000047613,AMER ACADEMY OF DRAMATIC ARTS,277,277,0,0,0,0,0,0,0,0,277,0,125,0,277,277
2010,31,NEW YORK,2,INDEPENDENT,1,PRIVATE,0,2-Year,403700,800000047634,AMERICAN ACAD MCALLISTER INST,131,131,0,238,238,0,0,0,0,0,131,238,28,16,369,210.33
2011,31,NEW YORK,2,INDEPENDENT,1,PRIVATE,0,2-Year,403700,800000047634,AMERICAN ACAD MCALLISTER INST,150,150,0,246,246,0,0,0,0,0,150,246,43,12,396,232
2012,31,NEW YORK,2,INDEPENDENT,1,PRIVATE,0,2-Year,403700,800000047634,AMERICAN ACAD MCALLISTER INST,132,132,0,276,276,0,0,0,0,0,132,276,26,14,408,224
2013,31,NEW YORK,2,INDEPENDENT,1,PRIVATE,0,2-Year,403700,800000047634,AMERICAN ACAD MCALLISTER INST,103,103,0,317,317,0,0,0,0,0,103,317,21,25,420,208.67
2014,31,NEW YORK,2,INDEPENDENT,1,PRIVATE,0,2-Year,403700,800000047634,AMERICAN ACAD MCALLISTER INST,88,88,0,337,337,0,0,0,0,0,88,337,14,26,425,200.33
2015,31,NEW YORK,2,INDEPENDENT,1,PRIVATE,0,2-Year,403700,800000047634,AMERICAN ACAD MCALLISTER INST,104,104,0,378,378,0,0,0,0,0,104,378,29,47,482,230
2016,31,NEW YORK,2,INDEPENDENT,1,PRIVATE,0,2-Year,403700,800000047634,AMERICAN ACAD MCALLISTER INST,77,77,0,405,405,0,0,0,0,0,77,405,26,62,482,212
2017,31,NEW YORK,2,INDEPENDENT,1,PRIVATE,0,2-Year,403700,800000047634,AMERICAN ACAD MCALLISTER INST,82,82,0,402,402,0,0,0,0,0,82,402,19,45,484,216
2018,31,NEW YORK,2,INDEPENDENT,1,PRIVATE,0,2-Year,403700,800000047634,AMERICAN ACAD MCALLISTER INST,61,61,0,380,380,0,0,0,0,0,61,380,11,19,441,187.67
2019,31,NEW YORK,2,INDEPENDENT,1,PRIVATE,0,2-Year,403700,800000047634,AMERICAN ACAD MCALLISTER INST,67,67,0,395,395,0,0,0,0,0,67,395,17,33,462,198.67
2010,31,NEW YORK,2,INDEPENDENT,1,PRIVATE,1,4-Year/Grad,403800,800000047344,AMERICAN MUSEUM OF NATURAL HISTORY,0,0,0,0,0,0,0,0,13,4,13,4,0,0,17,14.6
2011,31,NEW YORK,2,INDEPENDENT,1,PRIVATE,1,4-Year/Grad,403800,800000047344,AMERICAN MUSEUM OF NATURAL HISTORY,0,0,0,0,0,0,0,0,17,9,17,9,0,0,26,20.6
2012,31,NEW YORK,2,INDEPENDENT,1,PRIVATE,1,4-Year/Grad,403800,800000047344,AMERICAN MUSEUM OF NATURAL HISTORY,0,0,0,0,0,0,0,0,20,1,20,1,0,0,21,20.4
2013,31,NEW YORK,2,INDEPENDENT,1,PRIVATE,1,4-Year/Grad,403800,800000047344,AMERICAN MUSEUM OF NATURAL HISTORY,0,0,0,0,0,0,0,0,17,3,17,3,0,0,20,18.2
2014,31,NEW YORK,2,INDEPENDENT,1,PRIVATE,1,4-Year/Grad,403800,800000047344,AMERICAN MUSEUM OF NATURAL HISTORY,0,0,0,0,0,0,0,0,17,3,17,3,0,0,20,18.2
2015,31,NEW YORK,2,INDEPENDENT,1,PRIVATE,1,4-Year/Grad,403800,800000047344,AMERICAN MUSEUM OF NATURAL HISTORY,0,0,0,0,0,0,0,0,32,0,32,0,0,0,32,32
2016,31,NEW YORK,2,INDEPENDENT,1,PRIVATE,1,4-Year/Grad,403800,800000047344,AMERICAN MUSEUM OF NATURAL HISTORY,0,0,0,0,0,0,0,0,30,0,30,0,0,0,30,30
2017,31,NEW YORK,2,INDEPENDENT,1,PRIVATE,1,4-Year/Grad,403800,800000047344,AMERICAN MUSEUM OF NATURAL HISTORY,0,0,0,0,0,0,0,0,33,0,33,0,0,0,33,33
2018,31,NEW YORK,2,INDEPENDENT,1,PRIVATE,1,4-Year/Grad,403800,800000047344,AMERICAN MUSEUM OF NATURAL HISTORY,0,0,0,0,0,0,0,0,30,0,30,0,0,0,30,30
2019,31,NEW YORK,2,INDEPENDENT,1,PRIVATE,1,4-Year/Grad,403800,800000047344,AMERICAN MUSEUM OF NATURAL HISTORY,0,0,0,0,0,0,0,0,31,0,31,0,0,0,31,31
2010,31,NEW YORK,2,INDEPENDENT,1,PRIVATE,1,4-Year/Grad,404500,800000047353,BANK STREET COLLEGE OF EDUCATION,0,0,0,0,0,0,0,0,353,671,353,671,0,0,1024,621.4
2011,31,NEW YORK,2,INDEPENDENT,1,PRIVATE,1,4-Year/Grad,404500,800000047353,BANK STREET COLLEGE OF EDUCATION,0,0,0,0,0,0,0,0,378,649,378,649,0,0,1027,637.6
2012,31,NEW YORK,2,INDEPENDENT,1,PRIVATE,1,4-Year/Grad,404500,800000047353,BANK STREET COLLEGE OF EDUCATION,0,0,0,0,0,0,0,0,359,570,359,570,0,0,929,587
2013,31,NEW YORK,2,INDEPENDENT,1,PRIVATE,1,4-Year/Grad,404500,800000047353,BANK STREET COLLEGE OF EDUCATION,0,0,0,0,0,0,0,0,355,491,355,491,0,0,846,551.4
2014,31,NEW YORK,2,INDEPENDENT,1,PRIVATE,1,4-Year/Grad,404500,800000047353,BANK STREET COLLEGE OF EDUCATION,0,0,0,0,0,0,0,0,279,468,279,468,0,0,747,466.2
2015,31,NEW YORK,2,INDEPENDENT,1,PRIVATE,1,4-Year/Grad,404500,800000047353,BANK STREET COLLEGE OF EDUCATION,0,0,0,0,0,0,0,0,270,439,270,439,0,0,709,445.6
2016,31,NEW YORK,2,INDEPENDENT,1,PRIVATE,1,4-Year/Grad,404500,800000047353,BANK STREET COLLEGE OF EDUCATION,0,0,0,0,0,0,0,0,270,376,270,376,0,0,646,420.4
2017,31,NEW YORK,2,INDEPENDENT,1,PRIVATE,1,4-Year/Grad,404500,800000047353,BANK STREET COLLEGE OF EDUCATION,0,0,0,0,0,0,0,0,242,443,242,443,0,0,685,419.2
2018,31,NEW YORK,2,INDEPENDENT,1,PRIVATE,1,4-Year/Grad,404500,800000047353,BANK STREET COLLEGE OF EDUCATION,0,0,0,0,0,0,0,0,322,343,322,343,0,0,665,459.2
2019,31,NEW YORK,2,INDEPENDENT,1,PRIVATE,1,4-Year/Grad,404500,800000047353,BANK STREET COLLEGE OF EDUCATION,0,0,0,0,0,0,0,0,335,375,335,375,0,0,710,485
2010,13,DUTCHESS,2,INDEPENDENT,1,PRIVATE,1,4-Year/Grad,405000,800000053225,BARD COLLEGE,2650,2633,17,43,30,13,0,0,230,9,2880,52,863,0,2932,2897.93
2011,13,DUTCHESS,2,INDEPENDENT,1,PRIVATE,1,4-Year/Grad,405000,800000053225,BARD COLLEGE,2783,2663,120,72,49,23,0,0,176,5,2959,77,755,0,3036,2985
2012,13,DUTCHESS,2,INDEPENDENT,1,PRIVATE,1,4-Year/Grad,405000,800000053225,BARD COLLEGE,2704,2638,66,93,48,45,0,0,168,8,2872,101,819,0,2973,2906.2
2013,13,DUTCHESS,2,INDEPENDENT,1,PRIVATE,1,4-Year/Grad,405000,800000053225,BARD COLLEGE,2750,2662,88,96,61,35,0,0,172,18,2922,114,808,0,3036,2961.2
2014,13,DUTCHESS,2,INDEPENDENT,1,PRIVATE,1,4-Year/Grad,405000,800000053225,BARD COLLEGE,2814,2743,71,72,38,34,0,0,179,15,2993,87,836,0,3080,3023
2015,13,DUTCHESS,2,INDEPENDENT,1,PRIVATE,1,4-Year/Grad,405000,800000053225,BARD COLLEGE,2586,2559,27,253,200,53,0,0,215,11,2801,264,697,0,3065,2889.73
2016,13,DUTCHESS,2,INDEPENDENT,1,PRIVATE,1,4-Year/Grad,405000,800000053225,BARD COLLEGE,2621,2583,38,242,147,95,0,0,275,9,2896,251,778,11,3147,2980.27
2017,13,DUTCHESS,2,INDEPENDENT,1,PRIVATE,1,4-Year/Grad,405000,800000053225,BARD COLLEGE,2632,2526,106,187,97,90,0,0,269,11,2901,198,742,11,3099,2967.73
2018,13,DUTCHESS,2,INDEPENDENT,1,PRIVATE,1,4-Year/Grad,405000,800000053225,BARD COLLEGE,2511,2447,64,157,93,64,0,0,264,10,2775,167,733,0,2942,2831.33
2019,13,DUTCHESS,2,INDEPENDENT,1,PRIVATE,1,4-Year/Grad,405000,800000053225,BARD COLLEGE,2610,2529,81,149,88,61,0,0,264,18,2874,167,765,0,3041,2930.87
2010,31,NEW YORK,2,INDEPENDENT,1,PRIVATE,1,4-Year/Grad,405010,800000047370,BARD GRAD CTR FOR DECORATIVE ARTS,0,0,0,0,0,0,0,0,49,3,49,3,0,0,52,50.2
2011,31,NEW YORK,2,INDEPENDENT,1,PRIVATE,1,4-Year/Grad,405010,800000047370,BARD GRAD CTR FOR DECORATIVE ARTS,0,0,0,0,0,0,0,0,38,20,38,20,0,0,58,46
2012,31,NEW YORK,2,INDEPENDENT,1,PRIVATE,1,4-Year/Grad,405010,800000047370,BARD GRAD CTR FOR DECORATIVE ARTS,0,0,0,0,0,0,0,0,40,20,40,20,0,0,60,48
2013,31,NEW YORK,2,INDEPENDENT,1,PRIVATE,1,4-Year/Grad,405010,800000047370,BARD GRAD CTR FOR DECORATIVE ARTS,0,0,0,0,0,0,0,0,45,11,45,11,0,0,56,49.4
2014,31,NEW YORK,2,INDEPENDENT,1,PRIVATE,1,4-Year/Grad,405010,800000047370,BARD GRAD CTR FOR DECORATIVE ARTS,0,0,0,0,0,0,0,0,49,7,49,7,0,0,56,51.8
2015,31,NEW YORK,2,INDEPENDENT,1,PRIVATE,1,4-Year/Grad,405010,800000047370,BARD GRAD CTR FOR DECORATIVE ARTS,0,0,0,0,0,0,0,0,44,10,44,10,0,0,54,48
2016,31,NEW YORK,2,INDEPENDENT,1,PRIVATE,1,4-Year/Grad,405010,800000047370,BARD GRAD CTR FOR DECORATIVE ARTS,0,0,0,0,0,0,0,0,42,15,42,15,0,0,57,48
2017,31,NEW YORK,2,INDEPENDENT,1,PRIVATE,1,4-Year/Grad,405010,800000047370,BARD GRAD CTR FOR DECORATIVE ARTS,0,0,0,0,0,0,0,0,39,18,39,18,0,0,57,46.2
2018,31,NEW YORK,2,INDEPENDENT,1,PRIVATE,1,4-Year/Grad,405010,800000047370,BARD GRAD CTR FOR DECORATIVE ARTS,0,0,0,0,0,0,0,0,37,10,37,10,0,0,47,41
2019,31,NEW YORK,2,INDEPENDENT,1,PRIVATE,1,4-Year/Grad,405010,800000047370,BARD GRAD CTR FOR DECORATIVE ARTS,0,0,0,0,0,0,0,0,36,12,36,12,0,0,48,40.8
2019,33,KINGS,2,INDEPENDENT,1,PRIVATE,0,2-Year,405020,800000090122,BARD COLLEGE AT BROOKLYN PUBLIC CENTRAL LIBRARY,29,29,0,5,3,2,0,0,0,0,29,5,12,0,34,30.67
2010,31,NEW YORK,2,INDEPENDENT,1,PRIVATE,1,4-Year/Grad,405500,800000047062,BARNARD COLLEGE,2335,2335,0,55,55,0,0,0,0,0,2335,55,570,10,2390,2353.33
2011,31,NEW YORK,2,INDEPENDENT,1,PRIVATE,1,4-Year/Grad,405500,800000047062,BARNARD COLLEGE,2328,2328,0,48,48,0,0,0,0,0,2328,48,606,6,2376,2344
2012,31,NEW YORK,2,INDEPENDENT,1,PRIVATE,1,4-Year/Grad,405500,800000047062,BARNARD COLLEGE,2461,2461,0,30,30,0,0,0,0,0,2461,30,594,5,2491,2471
2013,31,NEW YORK,2,INDEPENDENT,1,PRIVATE,1,4-Year/Grad,405500,800000047062,BARNARD COLLEGE,2463,2463,0,26,26,0,0,0,0,0,2463,26,576,4,2489,2471.67
2014,31,NEW YORK,2,INDEPENDENT,1,PRIVATE,1,4-Year/Grad,405500,800000047062,BARNARD COLLEGE,2539,2539,0,25,25,0,0,0,0,0,2539,25,613,6,2564,2547.33
2015,31,NEW YORK,2,INDEPENDENT,1,PRIVATE,1,4-Year/Grad,405500,800000047062,BARNARD COLLEGE,2511,2510,1,37,32,5,0,0,0,0,2511,37,626,9,2548,2523.33
2016,31,NEW YORK,2,INDEPENDENT,1,PRIVATE,1,4-Year/Grad,405500,800000047062,BARNARD COLLEGE,2539,2539,0,49,45,4,0,0,0,0,2539,49,592,13,2588,2555.33
2017,31,NEW YORK,2,INDEPENDENT,1,PRIVATE,1,4-Year/Grad,405500,800000047062,BARNARD COLLEGE,2574,2574,0,30,30,0,0,0,0,0,2574,30,595,8,2604,2584
2018,31,NEW YORK,2,INDEPENDENT,1,PRIVATE,1,4-Year/Grad,405500,800000047062,BARNARD COLLEGE,2592,2592,0,43,43,0,0,0,0,0,2592,43,602,3,2635,2606.33
2019,31,NEW YORK,2,INDEPENDENT,1,PRIVATE,1,4-Year/Grad,405500,800000047062,BARNARD COLLEGE,2630,2630,0,47,47,0,0,0,0,0,2630,47,624,8,2677,2645.67
2010,31,NEW YORK,2,INDEPENDENT,1,PRIVATE,0,2-Year,406500,800000047633,PHILLIPS BETH ISRAEL SCH OF NURSING,20,20,0,233,233,0,0,0,0,0,20,233,1,6,253,97.67
2011,31,NEW YORK,2,INDEPENDENT,1,PRIVATE,0,2-Year,406500,800000047633,PHILLIPS BETH ISRAEL SCH OF NURSING,21,21,0,240,240,0,0,0,0,0,21,240,0,4,261,101
2012,31,NEW YORK,2,INDEPENDENT,1,PRIVATE,0,2-Year,406500,800000047633,PHILLIPS BETH ISRAEL SCH OF NURSING,23,23,0,264,264,0,0,0,0,0,23,264,1,5,287,111
2013,31,NEW YORK,2,INDEPENDENT,1,PRIVATE,0,2-Year,406500,800000047633,PHILLIPS BETH ISRAEL SCH OF NURSING,24,24,0,245,245,0,0,0,0,0,24,245,1,4,269,105.67
2014,31,NEW YORK,2,INDEPENDENT,1,PRIVATE,0,2-Year,406500,800000047633,PHILLIPS BETH ISRAEL SCH OF NURSING,29,29,0,255,255,0,0,0,0,0,29,255,1,6,284,114
2015,31,NEW YORK,2,INDEPENDENT,1,PRIVATE,0,2-Year,406500,800000047633,PHILLIPS BETH ISRAEL SCH OF NURSING,43,43,0,211,211,0,0,0,0,0,43,211,2,0,254,113.33
2016,31,NEW YORK,2,INDEPENDENT,1,PRIVATE,0,2-Year,406500,800000047633,PHILLIPS BETH ISRAEL SCH OF NURSING,39,39,0,163,163,0,0,0,0,0,39,163,1,0,202,93.33
2017,31,NEW YORK,2,INDEPENDENT,1,PRIVATE,0,2-Year,406500,800000047633,PHILLIPS BETH ISRAEL SCH OF NURSING,55,55,0,119,119,0,0,0,0,0,55,119,0,0,174,94.67
2018,31,NEW YORK,2,INDEPENDENT,1,PRIVATE,0,2-Year,406500,800000047633,PHILLIPS BETH ISRAEL SCH OF NURSING,89,89,0,110,110,0,0,0,0,0,89,110,0,0,199,125.67
2019,31,NEW YORK,2,INDEPENDENT,1,PRIVATE,0,2-Year,406500,800000047633,PHILLIPS BETH ISRAEL SCH OF NURSING,184,184,0,77,77,0,0,0,0,0,184,77,0,0,261,209.67
2010,34,QUEENS,2,INDEPENDENT,1,PRIVATE,1,4-Year/Grad,406600,800000064836,BETHEL SEMINARY OF THE EAST,0,0,0,0,0,0,2,6,2,5,4,11,0,0,15,8.4
2011,34,QUEENS,2,INDEPENDENT,1,PRIVATE,1,4-Year/Grad,406600,800000064836,BETHEL SEMINARY OF THE EAST,0,0,0,0,0,0,1,2,3,5,4,7,0,0,11,6.8
2012,34,QUEENS,2,INDEPENDENT,1,PRIVATE,1,4-Year/Grad,406600,800000064836,BETHEL SEMINARY OF THE EAST,0,0,0,0,0,0,2,2,1,5,3,7,0,0,10,5.8
2010,31,NEW YORK,2,INDEPENDENT,1,PRIVATE,1,4-Year/Grad,407000,800000046924,BORICUA COLLEGE,1203,1203,0,0,0,0,0,0,96,0,1299,0,349,0,1299,1299
2011,31,NEW YORK,2,INDEPENDENT,1,PRIVATE,1,4-Year/Grad,407000,800000046924,BORICUA COLLEGE,1208,1208,0,0,0,0,0,0,86,0,1294,0,282,0,1294,1294
2012,31,NEW YORK,2,INDEPENDENT,1,PRIVATE,1,4-Year/Grad,407000,800000046924,BORICUA COLLEGE,1176,1176,0,0,0,0,0,0,59,0,1235,0,239,0,1235,1235
2013,31,NEW YORK,2,INDEPENDENT,1,PRIVATE,1,4-Year/Grad,407000,800000046924,BORICUA COLLEGE,1060,1060,0,0,0,0,0,0,60,0,1120,0,220,0,1120,1120
2014,31,NEW YORK,2,INDEPENDENT,1,PRIVATE,1,4-Year/Grad,407000,800000046924,BORICUA COLLEGE,1104,1104,0,0,0,0,0,0,59,0,1163,0,227,0,1163,1163
2015,31,NEW YORK,2,INDEPENDENT,1,PRIVATE,1,4-Year/Grad,407000,800000046924,BORICUA COLLEGE,925,925,0,0,0,0,0,0,70,0,995,0,125,0,995,995
2016,31,NEW YORK,2,INDEPENDENT,1,PRIVATE,1,4-Year/Grad,407000,800000046924,BORICUA COLLEGE,180,180,0,0,0,0,0,0,0,0,180,0,35,0,180,180
2017,31,NEW YORK,2,INDEPENDENT,1,PRIVATE,1,4-Year/Grad,407000,800000046924,BORICUA COLLEGE,162,162,0,0,0,0,0,0,0,0,162,0,30,0,162,162
2018,31,NEW YORK,2,INDEPENDENT,1,PRIVATE,1,4-Year/Grad,407000,800000046924,BORICUA COLLEGE,148,148,0,0,0,0,0,0,0,0,148,0,148,0,148,148
2019,31,NEW YORK,2,INDEPENDENT,1,PRIVATE,1,4-Year/Grad,407000,800000046924,BORICUA COLLEGE,135,135,0,0,0,0,0,0,0,0,135,0,18,0,135,135
2016,33,KINGS,2,INDEPENDENT,1,PRIVATE,1,4-Year/Grad,407010,800000075234,BORICUA COLLEGE - BROOKLYN,398,398,0,0,0,0,0,0,52,0,450,0,55,0,450,450
2017,33,KINGS,2,INDEPENDENT,1,PRIVATE,1,4-Year/Grad,407010,800000075234,BORICUA COLLEGE - BROOKLYN,336,336,0,0,0,0,0,0,58,0,394,0,39,0,394,394
2018,33,KINGS,2,INDEPENDENT,1,PRIVATE,1,4-Year/Grad,407010,800000075234,BORICUA COLLEGE - BROOKLYN,273,273,0,0,0,0,0,0,39,0,312,0,312,0,312,312
2019,33,KINGS,2,INDEPENDENT,1,PRIVATE,1,4-Year/Grad,407010,800000075234,BORICUA COLLEGE - BROOKLYN,282,282,0,0,0,0,0,0,41,0,323,0,37,0,323,323
2016,32,BRONX,2,INDEPENDENT,1,PRIVATE,1,4-Year/Grad,407020,800000075233,BORICUA COLLEGE - BRONX,321,321,0,0,0,0,0,0,57,0,378,0,44,0,378,378
2017,32,BRONX,2,INDEPENDENT,1,PRIVATE,1,4-Year/Grad,407020,800000075233,BORICUA COLLEGE - BRONX,271,271,0,0,0,0,0,0,54,0,325,0,61,0,325,325
2018,32,BRONX,2,INDEPENDENT,1,PRIVATE,1,4-Year/Grad,407020,800000075233,BORICUA COLLEGE - BRONX,218,218,0,0,0,0,0,0,54,0,272,0,218,0,272,272
2019,32,BRONX,2,INDEPENDENT,1,PRIVATE,1,4-Year/Grad,407020,800000075233,BORICUA COLLEGE - BRONX,213,213,0,0,0,0,0,0,48,0,261,0,19,0,261,261
2010,31,NEW YORK,2,INDEPENDENT,1,PRIVATE,1,4-Year/Grad,407300,800000059266,NEW YORK GRADUATE SCHOOL OF PSYCHOANALYSIS,0,0,0,0,0,0,0,0,8,24,8,24,0,0,32,17.6
2011,31,NEW YORK,2,INDEPENDENT,1,PRIVATE,1,4-Year/Grad,407300,800000059266,NEW YORK GRADUATE SCHOOL OF PSYCHOANALYSIS,0,0,0,0,0,0,0,0,17,21,17,21,0,0,38,25.4
2012,31,NEW YORK,2,INDEPENDENT,1,PRIVATE,1,4-Year/Grad,407300,800000059266,NEW YORK GRADUATE SCHOOL OF PSYCHOANALYSIS,0,0,0,0,0,0,0,0,21,17,21,17,0,0,38,27.8
2013,31,NEW YORK,2,INDEPENDENT,1,PRIVATE,1,4-Year/Grad,407300,800000059266,NEW YORK GRADUATE SCHOOL OF PSYCHOANALYSIS,0,0,0,0,0,0,0,0,7,25,7,25,0,0,32,17
2014,31,NEW YORK,2,INDEPENDENT,1,PRIVATE,1,4-Year/Grad,407300,800000059266,NEW YORK GRADUATE SCHOOL OF PSYCHOANALYSIS,0,0,0,0,0,0,0,0,9,21,9,21,0,0,30,17.4
2015,31,NEW YORK,2,INDEPENDENT,1,PRIVATE,1,4-Year/Grad,407300,800000059266,NEW YORK GRADUATE SCHOOL OF PSYCHOANALYSIS,0,0,0,0,0,0,0,0,7,22,7,22,0,0,29,15.8
2016,31,NEW YORK,2,INDEPENDENT,1,PRIVATE,1,4-Year/Grad,407300,800000059266,NEW YORK GRADUATE SCHOOL OF PSYCHOANALYSIS,0,0,0,0,0,0,0,0,17,17,17,17,0,0,34,23.8
2010,34,QUEENS,2,INDEPENDENT,1,PRIVATE,0,2-Year,407500,800000042568,BRAMSON ORT COLLEGE,848,848,0,94,46,48,0,0,0,0,848,94,301,0,942,879.33
2011,34,QUEENS,2,INDEPENDENT,1,PRIVATE,0,2-Year,407500,800000042568,BRAMSON ORT COLLEGE,868,868,0,56,34,22,0,0,0,0,868,56,286,2,924,886.67
2012,34,QUEENS,2,INDEPENDENT,1,PRIVATE,0,2-Year,407500,800000042568,BRAMSON ORT COLLEGE,700,700,0,92,41,51,0,0,0,0,700,92,222,6,792,730.67
2013,34,QUEENS,2,INDEPENDENT,1,PRIVATE,0,2-Year,407500,800000042568,BRAMSON ORT COLLEGE,742,742,0,162,40,122,0,0,0,0,742,162,201,3,904,796
2014,34,QUEENS,2,INDEPENDENT,1,PRIVATE,0,2-Year,407500,800000042568,BRAMSON ORT COLLEGE,555,555,0,125,41,84,0,0,0,0,555,125,118,8,680,596.67
2015,34,QUEENS,2,INDEPENDENT,1,PRIVATE,0,2-Year,407500,800000042568,BRAMSON ORT COLLEGE,424,424,0,56,54,2,0,0,0,0,424,56,114,10,480,442.67
2016,34,QUEENS,2,INDEPENDENT,1,PRIVATE,0,2-Year,407500,800000042568,BRAMSON ORT COLLEGE,443,443,0,14,0,14,0,0,0,0,443,14,113,14,457,447.67
2010,33,KINGS,2,INDEPENDENT,1,PRIVATE,1,4-Year/Grad,409000,800000045456,BROOKLYN LAW SCHOOL,0,0,0,0,0,0,1293,168,0,0,1293,168,0,0,1461,1360.2
2011,33,KINGS,2,INDEPENDENT,1,PRIVATE,1,4-Year/Grad,409000,800000045456,BROOKLYN LAW SCHOOL,0,0,0,0,0,0,1204,172,0,0,1204,172,0,0,1376,1272.8
2012,33,KINGS,2,INDEPENDENT,1,PRIVATE,1,4-Year/Grad,409000,800000045456,BROOKLYN LAW SCHOOL,0,0,0,0,0,0,1110,149,6,4,1116,153,0,0,1269,1177.2
2013,33,KINGS,2,INDEPENDENT,1,PRIVATE,1,4-Year/Grad,409000,800000045456,BROOKLYN LAW SCHOOL,0,0,0,0,0,0,995,123,8,10,1003,133,0,0,1136,1056.2
2014,33,KINGS,2,INDEPENDENT,1,PRIVATE,1,4-Year/Grad,409000,800000045456,BROOKLYN LAW SCHOOL,0,0,0,0,0,0,881,238,0,0,881,238,0,0,1119,976.2
2015,33,KINGS,2,INDEPENDENT,1,PRIVATE,1,4-Year/Grad,409000,800000045456,BROOKLYN LAW SCHOOL,0,0,0,0,0,0,907,247,15,10,922,257,0,0,1179,1024.8
2010,14,ERIE,2,INDEPENDENT,1,PRIVATE,1,4-Year/Grad,410000,800000052570,CANISIUS COLLEGE,3011,2989,22,358,76,282,0,0,887,855,3898,1213,730,230,5111,4359.33
2011,14,ERIE,2,INDEPENDENT,1,PRIVATE,1,4-Year/Grad,410000,800000052570,CANISIUS COLLEGE,3028,3006,22,353,74,279,0,0,860,907,3888,1260,830,48,5148,4368.47
2012,14,ERIE,2,INDEPENDENT,1,PRIVATE,1,4-Year/Grad,410000,800000052570,CANISIUS COLLEGE,2954,2930,24,326,62,264,0,0,736,892,3690,1218,712,1,4908,4155.47
2013,14,ERIE,2,INDEPENDENT,1,PRIVATE,1,4-Year/Grad,410000,800000052570,CANISIUS COLLEGE,2825,2800,25,259,58,201,0,0,618,835,3443,1094,680,2,4537,3863.33
2014,14,ERIE,2,INDEPENDENT,1,PRIVATE,1,4-Year/Grad,410000,800000052570,CANISIUS COLLEGE,2725,2700,25,143,36,107,0,0,562,751,3287,894,613,0,4181,3635.07
2015,14,ERIE,2,INDEPENDENT,1,PRIVATE,1,4-Year/Grad,410000,800000052570,CANISIUS COLLEGE,2538,2517,21,133,35,98,0,0,500,733,3038,866,605,0,3904,3375.53
2016,14,ERIE,2,INDEPENDENT,1,PRIVATE,1,4-Year/Grad,410000,800000052570,CANISIUS COLLEGE,2474,2453,21,121,35,86,0,0,485,654,2959,775,600,0,3734,3260.93
2017,14,ERIE,2,INDEPENDENT,1,PRIVATE,1,4-Year/Grad,410000,800000052570,CANISIUS COLLEGE,2303,2302,1,95,39,56,0,0,492,574,2795,669,553,0,3464,3056.27
2018,14,ERIE,2,INDEPENDENT,1,PRIVATE,1,4-Year/Grad,410000,800000052570,CANISIUS COLLEGE,2166,2153,13,89,37,52,0,0,474,514,2640,603,484,1,3243,2875.27
2019,14,ERIE,2,INDEPENDENT,1,PRIVATE,1,4-Year/Grad,410000,800000052570,CANISIUS COLLEGE,2112,2038,74,101,43,58,0,0,394,495,2506,596,553,1,3102,2737.67
2010,25,MADISON,2,INDEPENDENT,1,PRIVATE,1,4-Year/Grad,411500,800000050956,CAZENOVIA COLLEGE,955,955,0,137,112,25,0,0,0,0,955,137,246,0,1092,1000.67
2011,25,MADISON,2,INDEPENDENT,1,PRIVATE,1,4-Year/Grad,411500,800000050956,CAZENOVIA COLLEGE,899,899,0,144,126,18,0,0,0,0,899,144,271,0,1043,947
2012,25,MADISON,2,INDEPENDENT,1,PRIVATE,1,4-Year/Grad,411500,800000050956,CAZENOVIA COLLEGE,884,884,0,109,100,9,0,0,0,0,884,109,268,0,993,920.33
2013,25,MADISON,2,INDEPENDENT,1,PRIVATE,1,4-Year/Grad,411500,800000050956,CAZENOVIA COLLEGE,937,937,0,140,94,46,0,0,0,0,937,140,345,0,1077,983.67
2014,25,MADISON,2,INDEPENDENT,1,PRIVATE,1,4-Year/Grad,411500,800000050956,CAZENOVIA COLLEGE,963,963,0,128,104,24,0,0,0,0,963,128,265,0,1091,1005.67
2015,25,MADISON,2,INDEPENDENT,1,PRIVATE,1,4-Year/Grad,411500,800000050956,CAZENOVIA COLLEGE,943,943,0,129,107,22,0,0,0,0,943,129,250,0,1072,986
2016,25,MADISON,2,INDEPENDENT,1,PRIVATE,1,4-Year/Grad,411500,800000050956,CAZENOVIA COLLEGE,854,854,0,188,137,51,0,0,0,0,854,188,199,16,1042,916.67
2017,25,MADISON,2,INDEPENDENT,1,PRIVATE,1,4-Year/Grad,411500,800000050956,CAZENOVIA COLLEGE,713,713,0,180,123,57,0,0,0,0,713,180,165,0,893,773
2018,25,MADISON,2,INDEPENDENT,1,PRIVATE,1,4-Year/Grad,411500,800000050956,CAZENOVIA COLLEGE,670,670,0,212,141,71,0,0,0,0,670,212,157,29,882,740.67
2019,25,MADISON,2,INDEPENDENT,1,PRIVATE,1,4-Year/Grad,411500,800000050956,CAZENOVIA COLLEGE,694,691,3,162,150,12,0,0,9,0,703,162,218,0,865,757
2010,14,ERIE,2,INDEPENDENT,1,PRIVATE,1,4-Year/Grad,412000,800000052979,CHRIST THE KING SEMINARY,0,0,0,0,0,0,19,13,0,46,19,59,0,0,78,42.6
2011,14,ERIE,2,INDEPENDENT,1,PRIVATE,1,4-Year/Grad,412000,800000052979,CHRIST THE KING SEMINARY,0,0,0,0,0,0,11,16,2,55,13,71,0,0,84,41.4
2012,14,ERIE,2,INDEPENDENT,1,PRIVATE,1,4-Year/Grad,412000,800000052979,CHRIST THE KING SEMINARY,0,0,0,0,0,0,13,13,1,56,14,69,0,0,83,41.6
2013,14,ERIE,2,INDEPENDENT,1,PRIVATE,1,4-Year/Grad,412000,800000052979,CHRIST THE KING SEMINARY,0,0,0,0,0,0,16,17,6,57,22,74,0,0,96,51.6
2014,14,ERIE,2,INDEPENDENT,1,PRIVATE,1,4-Year/Grad,412000,800000052979,CHRIST THE KING SEMINARY,0,0,0,0,0,0,21,18,2,55,23,73,0,0,96,52.2
2015,14,ERIE,2,INDEPENDENT,1,PRIVATE,1,4-Year/Grad,412000,800000052979,CHRIST THE KING SEMINARY,0,0,0,0,0,0,17,22,1,49,18,71,0,0,89,46.4
2016,14,ERIE,2,INDEPENDENT,1,PRIVATE,1,4-Year/Grad,412000,800000052979,CHRIST THE KING SEMINARY,0,0,0,0,0,0,31,3,0,46,31,49,0,0,80,50.6
2017,14,ERIE,2,INDEPENDENT,1,PRIVATE,1,4-Year/Grad,412000,800000052979,CHRIST THE KING SEMINARY,0,0,0,0,0,0,26,5,1,46,27,51,0,0,78,47.4
2018,14,ERIE,2,INDEPENDENT,1,PRIVATE,1,4-Year/Grad,412000,800000052979,CHRIST THE KING SEMINARY,0,0,0,0,0,0,27,2,0,33,27,35,0,0,62,41
2019,14,ERIE,2,INDEPENDENT,1,PRIVATE,1,4-Year/Grad,412000,800000052979,CHRIST THE KING SEMINARY,0,0,0,0,0,0,21,0,0,35,21,35,0,0,56,35
2018,31,NEW YORK,2,INDEPENDENT,1,PRIVATE,1,4-Year/Grad,412010,800000090092,CITY SEMINARY OF NEW YORK GRADUATE CENTER,0,0,0,0,0,0,0,0,0,17,0,17,0,0,17,6.8
2010,51,SAINT LAWRENCE,2,INDEPENDENT,1,PRIVATE,1,4-Year/Grad,412500,800000038743,CLARKSON UNIVERSITY,2824,2793,31,24,7,17,52,0,377,53,3253,77,712,9,3330,3282.2
2011,51,SAINT LAWRENCE,2,INDEPENDENT,1,PRIVATE,1,4-Year/Grad,412500,800000038743,CLARKSON UNIVERSITY,2997,2968,29,21,7,14,60,0,400,61,3457,82,851,0,3539,3488.4
2012,51,SAINT LAWRENCE,2,INDEPENDENT,1,PRIVATE,1,4-Year/Grad,412500,800000038743,CLARKSON UNIVERSITY,3050,3003,47,22,11,11,66,1,435,30,3551,53,778,1,3604,3570.73
2013,51,SAINT LAWRENCE,2,INDEPENDENT,1,PRIVATE,1,4-Year/Grad,412500,800000038743,CLARKSON UNIVERSITY,3084,3049,35,26,11,15,73,0,445,98,3602,124,757,0,3726,3649.87
2014,51,SAINT LAWRENCE,2,INDEPENDENT,1,PRIVATE,1,4-Year/Grad,412500,800000038743,CLARKSON UNIVERSITY,3166,3121,45,81,9,72,70,1,394,161,3630,243,767,0,3873,3721.8
2015,51,SAINT LAWRENCE,2,INDEPENDENT,1,PRIVATE,1,4-Year/Grad,412500,800000038743,CLARKSON UNIVERSITY,3185,3147,38,72,6,66,73,0,375,205,3633,277,792,0,3910,3739
2016,51,SAINT LAWRENCE,2,INDEPENDENT,1,PRIVATE,1,4-Year/Grad,412500,800000038743,CLARKSON UNIVERSITY,3203,3164,39,65,12,53,73,0,437,202,3713,267,797,0,3980,3815.47
2017,51,SAINT LAWRENCE,2,INDEPENDENT,1,PRIVATE,1,4-Year/Grad,412500,800000038743,CLARKSON UNIVERSITY,3021,2979,42,69,12,57,63,1,441,181,3525,251,677,0,3776,3620.8
2018,51,SAINT LAWRENCE,2,INDEPENDENT,1,PRIVATE,1,4-Year/Grad,412500,800000038743,CLARKSON UNIVERSITY,3016,2973,43,75,10,65,69,0,424,280,3509,355,797,0,3864,3646
2019,51,SAINT LAWRENCE,2,INDEPENDENT,1,PRIVATE,1,4-Year/Grad,412500,800000038743,CLARKSON UNIVERSITY,3012,2965,47,69,17,52,67,0,451,339,3530,408,789,1,3938,3688.6
2016,53,SCHENECTADY,2,INDEPENDENT,1,PRIVATE,1,4-Year/Grad,412510,800000087726,CLARKSON UNIVERSITY CAPITAL REGION,0,0,0,0,0,0,0,0,177,227,177,227,0,0,404,267.8
2017,53,SCHENECTADY,2,INDEPENDENT,1,PRIVATE,1,4-Year/Grad,412510,800000087726,CLARKSON UNIVERSITY CAPITAL REGION,0,0,0,0,0,0,0,0,142,315,142,315,0,0,457,268
2018,53,SCHENECTADY,2,INDEPENDENT,1,PRIVATE,1,4-Year/Grad,412510,800000087726,CLARKSON UNIVERSITY CAPITAL REGION,0,0,0,0,0,0,0,0,142,268,142,268,0,0,410,249.2
2019,53,SCHENECTADY,2,INDEPENDENT,1,PRIVATE,1,4-Year/Grad,412510,800000087726,CLARKSON UNIVERSITY CAPITAL REGION,0,0,0,0,0,0,0,0,89,274,89,274,0,0,363,198.6
2010,66,WESTCHESTER,2,INDEPENDENT,1,PRIVATE,0,2-Year,412700,800000034614,COCHRAN SCH NURSING ST JOHN RVRDL HO,44,44,0,193,193,0,0,0,0,0,44,193,0,0,237,108.33
2011,66,WESTCHESTER,2,INDEPENDENT,1,PRIVATE,0,2-Year,412700,800000034614,COCHRAN SCH NURSING ST JOHN RVRDL HO,44,44,0,113,113,0,0,0,0,0,44,113,0,0,157,81.67
2012,66,WESTCHESTER,2,INDEPENDENT,1,PRIVATE,0,2-Year,412700,800000034614,COCHRAN SCH NURSING ST JOHN RVRDL HO,20,20,0,68,68,0,0,0,0,0,20,68,0,0,88,42.67
2013,66,WESTCHESTER,2,INDEPENDENT,1,PRIVATE,0,2-Year,412700,800000034614,COCHRAN SCH NURSING ST JOHN RVRDL HO,10,10,0,69,69,0,0,0,0,0,10,69,0,0,79,33
2014,66,WESTCHESTER,2,INDEPENDENT,1,PRIVATE,0,2-Year,412700,800000034614,COCHRAN SCH NURSING ST JOHN RVRDL HO,12,12,0,86,86,0,0,0,0,0,12,86,0,0,98,40.67
2015,66,WESTCHESTER,2,INDEPENDENT,1,PRIVATE,0,2-Year,412700,800000034614,COCHRAN SCH NURSING ST JOHN RVRDL HO,12,12,0,77,77,0,0,0,0,0,12,77,0,0,89,37.67
2016,66,WESTCHESTER,2,INDEPENDENT,1,PRIVATE,0,2-Year,412700,800000034614,COCHRAN SCH NURSING ST JOHN RVRDL HO,13,13,0,83,83,0,0,0,0,0,13,83,0,0,96,40.67
2017,66,WESTCHESTER,2,INDEPENDENT,1,PRIVATE,0,2-Year,412700,800000034614,COCHRAN SCH NURSING ST JOHN RVRDL HO,27,27,0,93,93,0,0,0,0,0,27,93,0,0,120,58
2018,66,WESTCHESTER,2,INDEPENDENT,1,PRIVATE,0,2-Year,412700,800000034614,COCHRAN SCH NURSING ST JOHN RVRDL HO,26,26,0,81,81,0,0,0,0,0,26,81,0,0,107,53
2019,66,WESTCHESTER,2,INDEPENDENT,1,PRIVATE,0,2-Year,412700,800000034614,COCHRAN SCH NURSING ST JOHN RVRDL HO,10,10,0,77,77,0,0,0,0,0,10,77,0,0,87,35.67
2010,28,NASSAU,2,INDEPENDENT,1,PRIVATE,1,4-Year/Grad,412900,800000068498,COLD SPRING HARBOR--WATSON SCHOOL OF BIOLOGICAL SCIENCES,0,0,0,0,0,0,0,0,48,0,48,0,0,0,48,48
2011,28,NASSAU,2,INDEPENDENT,1,PRIVATE,1,4-Year/Grad,412900,800000068498,COLD SPRING HARBOR--WATSON SCHOOL OF BIOLOGICAL SCIENCES,0,0,0,0,0,0,0,0,52,0,52,0,0,0,52,52
2012,28,NASSAU,2,INDEPENDENT,1,PRIVATE,1,4-Year/Grad,412900,800000068498,COLD SPRING HARBOR--WATSON SCHOOL OF BIOLOGICAL SCIENCES,0,0,0,0,0,0,0,0,56,0,56,0,0,0,56,56
2013,28,NASSAU,2,INDEPENDENT,1,PRIVATE,1,4-Year/Grad,412900,800000068498,COLD SPRING HARBOR--WATSON SCHOOL OF BIOLOGICAL SCIENCES,0,0,0,0,0,0,0,0,50,0,50,0,0,0,50,50
2014,28,NASSAU,2,INDEPENDENT,1,PRIVATE,1,4-Year/Grad,412900,800000068498,COLD SPRING HARBOR--WATSON SCHOOL OF BIOLOGICAL SCIENCES,0,0,0,0,0,0,0,0,43,0,43,0,0,0,43,43
2015,28,NASSAU,2,INDEPENDENT,1,PRIVATE,1,4-Year/Grad,412900,800000068498,COLD SPRING HARBOR--WATSON SCHOOL OF BIOLOGICAL SCIENCES,0,0,0,0,0,0,0,0,42,0,42,0,0,0,42,42
2016,28,NASSAU,2,INDEPENDENT,1,PRIVATE,1,4-Year/Grad,412900,800000068498,COLD SPRING HARBOR--WATSON SCHOOL OF BIOLOGICAL SCIENCES,0,0,0,0,0,0,0,0,44,0,44,0,0,0,44,44
2017,28,NASSAU,2,INDEPENDENT,1,PRIVATE,1,4-Year/Grad,412900,800000068498,COLD SPRING HARBOR--WATSON SCHOOL OF BIOLOGICAL SCIENCES,0,0,0,0,0,0,0,0,44,0,44,0,0,0,44,44
2018,28,NASSAU,2,INDEPENDENT,1,PRIVATE,1,4-Year/Grad,412900,800000068498,COLD SPRING HARBOR--WATSON SCHOOL OF BIOLOGICAL SCIENCES,0,0,0,0,0,0,0,0,51,0,51,0,0,0,51,51
2019,28,NASSAU,2,INDEPENDENT,1,PRIVATE,1,4-Year/Grad,412900,800000068498,COLD SPRING HARBOR--WATSON SCHOOL OF BIOLOGICAL SCIENCES,0,0,0,0,0,0,0,0,51,0,51,0,0,0,51,51
2010,26,MONROE,2,INDEPENDENT,1,PRIVATE,1,4-Year/Grad,413000,800000050301,COLGATE-ROCHESTER DIVINITY SCHOOL,0,0,0,0,0,0,59,12,2,3,61,15,0,0,76,67
2011,26,MONROE,2,INDEPENDENT,1,PRIVATE,1,4-Year/Grad,413000,800000050301,COLGATE-ROCHESTER DIVINITY SCHOOL,0,0,0,0,0,0,53,17,0,4,53,21,0,0,74,61.4
2012,26,MONROE,2,INDEPENDENT,1,PRIVATE,1,4-Year/Grad,413000,800000050301,COLGATE-ROCHESTER DIVINITY SCHOOL,0,0,0,0,0,0,53,17,0,3,53,20,0,0,73,61
2013,26,MONROE,2,INDEPENDENT,1,PRIVATE,1,4-Year/Grad,413000,800000050301,COLGATE-ROCHESTER DIVINITY SCHOOL,0,0,0,0,0,0,39,21,3,4,42,25,0,0,67,52
2014,26,MONROE,2,INDEPENDENT,1,PRIVATE,1,4-Year/Grad,413000,800000050301,COLGATE-ROCHESTER DIVINITY SCHOOL,0,0,0,0,0,0,34,16,6,3,40,19,0,0,59,47.6
2015,26,MONROE,2,INDEPENDENT,1,PRIVATE,1,4-Year/Grad,413000,800000050301,COLGATE-ROCHESTER DIVINITY SCHOOL,0,0,0,0,0,0,34,13,8,0,42,13,0,0,55,47.2
2016,26,MONROE,2,INDEPENDENT,1,PRIVATE,1,4-Year/Grad,413000,800000050301,COLGATE-ROCHESTER DIVINITY SCHOOL,0,0,0,0,0,0,30,16,36,6,66,22,0,0,88,74.8
2017,26,MONROE,2,INDEPENDENT,1,PRIVATE,1,4-Year/Grad,413000,800000050301,COLGATE-ROCHESTER DIVINITY SCHOOL,0,0,0,0,0,0,20,10,16,3,36,13,0,0,49,41.2
2018,26,MONROE,2,INDEPENDENT,1,PRIVATE,1,4-Year/Grad,413000,800000050301,COLGATE-ROCHESTER DIVINITY SCHOOL,0,0,0,0,0,0,18,12,1,11,19,23,0,0,42,28.2
2019,26,MONROE,2,INDEPENDENT,1,PRIVATE,1,4-Year/Grad,413000,800000050301,COLGATE-ROCHESTER DIVINITY SCHOOL,0,0,0,0,0,0,12,1,13,29,25,30,0,0,55,37
2010,25,MADISON,2,INDEPENDENT,1,PRIVATE,1,4-Year/Grad,413500,800000050944,COLGATE UNIVERSITY,2868,2868,0,16,0,16,0,0,8,11,2876,27,850,9,2903,2885.73
2011,25,MADISON,2,INDEPENDENT,1,PRIVATE,1,4-Year/Grad,413500,800000050944,COLGATE UNIVERSITY,2926,2925,1,21,2,19,0,0,8,9,2934,30,764,0,2964,2944.6
2012,25,MADISON,2,INDEPENDENT,1,PRIVATE,1,4-Year/Grad,413500,800000050944,COLGATE UNIVERSITY,2850,2850,0,21,0,21,0,0,10,5,2860,26,756,0,2886,2869
2013,25,MADISON,2,INDEPENDENT,1,PRIVATE,1,4-Year/Grad,413500,800000050944,COLGATE UNIVERSITY,2871,2871,0,19,1,18,0,0,6,4,2877,23,759,0,2900,2884.93
2014,25,MADISON,2,INDEPENDENT,1,PRIVATE,1,4-Year/Grad,413500,800000050944,COLGATE UNIVERSITY,2863,2863,0,12,2,10,0,0,5,8,2868,20,767,0,2888,2875.2
2015,25,MADISON,2,INDEPENDENT,1,PRIVATE,1,4-Year/Grad,413500,800000050944,COLGATE UNIVERSITY,2834,2834,0,19,0,19,0,0,3,5,2837,24,773,0,2861,2845.33
2016,25,MADISON,2,INDEPENDENT,1,PRIVATE,1,4-Year/Grad,413500,800000050944,COLGATE UNIVERSITY,2864,2864,0,18,4,14,0,0,1,7,2865,25,766,0,2890,2873.8
2017,25,MADISON,2,INDEPENDENT,1,PRIVATE,1,4-Year/Grad,413500,800000050944,COLGATE UNIVERSITY,2854,2850,4,19,2,17,0,0,4,4,2858,23,771,0,2881,2865.93
2018,25,MADISON,2,INDEPENDENT,1,PRIVATE,1,4-Year/Grad,413500,800000050944,COLGATE UNIVERSITY,3053,3048,5,22,3,19,0,0,8,3,3061,25,815,0,3086,3069.53
2019,25,MADISON,2,INDEPENDENT,1,PRIVATE,1,4-Year/Grad,413500,800000050944,COLGATE UNIVERSITY,2968,2960,8,12,4,8,0,0,5,7,2973,19,786,0,2992,2979.8
2010,31,NEW YORK,2,INDEPENDENT,1,PRIVATE,1,4-Year/Grad,414000,800000047841,METROPOLITAN COLLEGE OF NEW YORK,766,766,0,41,41,0,0,0,337,49,1103,90,127,3,1193,1136.27
2011,31,NEW YORK,2,INDEPENDENT,1,PRIVATE,1,4-Year/Grad,414000,800000047841,METROPOLITAN COLLEGE OF NEW YORK,773,773,0,52,52,0,0,0,326,49,1099,101,93,2,1200,1135.93
2012,31,NEW YORK,2,INDEPENDENT,1,PRIVATE,1,4-Year/Grad,414000,800000047841,METROPOLITAN COLLEGE OF NEW YORK,851,851,0,59,59,0,0,0,329,38,1180,97,112,1,1277,1214.87
2013,31,NEW YORK,2,INDEPENDENT,1,PRIVATE,1,4-Year/Grad,414000,800000047841,METROPOLITAN COLLEGE OF NEW YORK,851,851,0,60,60,0,0,0,313,31,1164,91,113,2,1255,1196.4
2014,31,NEW YORK,2,INDEPENDENT,1,PRIVATE,1,4-Year/Grad,414000,800000047841,METROPOLITAN COLLEGE OF NEW YORK,806,806,0,91,91,0,0,0,278,53,1084,144,87,22,1228,1135.53
2015,31,NEW YORK,2,INDEPENDENT,1,PRIVATE,1,4-Year/Grad,414000,800000047841,METROPOLITAN COLLEGE OF NEW YORK,685,685,0,94,94,0,0,0,370,46,1055,140,74,5,1195,1104.73
2016,31,NEW YORK,2,INDEPENDENT,1,PRIVATE,1,4-Year/Grad,414000,800000047841,METROPOLITAN COLLEGE OF NEW YORK,621,621,0,76,72,4,0,0,308,54,929,130,74,1,1059,975.93
2017,31,NEW YORK,2,INDEPENDENT,1,PRIVATE,1,4-Year/Grad,414000,800000047841,METROPOLITAN COLLEGE OF NEW YORK,681,681,0,96,91,5,0,0,288,48,969,144,96,8,1113,1020.2
2018,31,NEW YORK,2,INDEPENDENT,1,PRIVATE,1,4-Year/Grad,414000,800000047841,METROPOLITAN COLLEGE OF NEW YORK,443,443,0,58,57,1,0,0,246,29,689,87,28,1,776,719.93
2019,31,NEW YORK,2,INDEPENDENT,1,PRIVATE,1,4-Year/Grad,414000,800000047841,METROPOLITAN COLLEGE OF NEW YORK,340,340,0,61,61,0,0,0,237,40,577,101,14,1,678,613.33
2018,66,WESTCHESTER,2,INDEPENDENT,1,PRIVATE,1,4-Year/Grad,414010,800000090123,METROPOLITAN COLLEGE OF NY-BRC,178,178,0,19,19,0,0,0,48,6,226,25,10,0,251,234.73
2019,66,WESTCHESTER,2,INDEPENDENT,1,PRIVATE,1,4-Year/Grad,414010,800000090123,METROPOLITAN COLLEGE OF NY-BRC,203,203,0,22,22,0,0,0,67,10,270,32,15,0,302,281.33
2010,32,BRONX,2,INDEPENDENT,1,PRIVATE,1,4-Year/Grad,415000,800000046097,COLLEGE OF MT ST VINCENT,1347,1347,0,253,180,73,0,0,48,241,1395,494,378,4,1889,1575.73
2011,32,BRONX,2,INDEPENDENT,1,PRIVATE,1,4-Year/Grad,415000,800000046097,COLLEGE OF MT ST VINCENT,1395,1395,0,229,221,8,0,0,57,268,1452,497,438,0,1949,1635.53
2012,32,BRONX,2,INDEPENDENT,1,PRIVATE,1,4-Year/Grad,415000,800000046097,COLLEGE OF MT ST VINCENT,1459,1459,0,236,200,36,0,0,22,212,1481,448,486,0,1929,1644.47
2013,32,BRONX,2,INDEPENDENT,1,PRIVATE,1,4-Year/Grad,415000,800000046097,COLLEGE OF MT ST VINCENT,1489,1485,4,180,146,34,0,0,50,219,1539,399,386,0,1938,1686.6
2014,32,BRONX,2,INDEPENDENT,1,PRIVATE,1,4-Year/Grad,415000,800000046097,COLLEGE OF MT ST VINCENT,1579,1573,6,109,97,12,0,0,49,177,1628,286,518,0,1914,1735.13
2015,32,BRONX,2,INDEPENDENT,1,PRIVATE,1,4-Year/Grad,415000,800000046097,COLLEGE OF MT ST VINCENT,1508,1505,3,86,80,6,0,0,31,182,1539,268,321,0,1807,1640.47
2016,32,BRONX,2,INDEPENDENT,1,PRIVATE,1,4-Year/Grad,415000,800000046097,COLLEGE OF MT ST VINCENT,1589,1583,6,113,100,13,0,0,49,159,1638,272,436,0,1910,1739.27
2017,32,BRONX,2,INDEPENDENT,1,PRIVATE,1,4-Year/Grad,415000,800000046097,COLLEGE OF MT ST VINCENT,1585,1583,2,100,83,17,0,0,50,165,1635,265,447,0,1900,1734.33
2018,32,BRONX,2,INDEPENDENT,1,PRIVATE,1,4-Year/Grad,415000,800000046097,COLLEGE OF MT ST VINCENT,1562,1562,0,70,68,2,0,0,44,181,1606,251,412,0,1857,1701.73
2019,32,BRONX,2,INDEPENDENT,1,PRIVATE,1,4-Year/Grad,415000,800000046097,COLLEGE OF MT ST VINCENT,1787,1783,4,80,57,23,0,0,53,157,1840,237,441,0,2077,1929.47
2010,66,WESTCHESTER,2,INDEPENDENT,1,PRIVATE,1,4-Year/Grad,415500,800000035120,COLLEGE OF NEW ROCHELLE,3254,3254,0,568,557,11,0,0,187,755,3441,1323,635,84,4764,3932.33
2011,66,WESTCHESTER,2,INDEPENDENT,1,PRIVATE,1,4-Year/Grad,415500,800000035120,COLLEGE OF NEW ROCHELLE,3005,3005,0,516,505,11,0,0,183,696,3188,1212,595,44,4400,3638.4
2012,66,WESTCHESTER,2,INDEPENDENT,1,PRIVATE,1,4-Year/Grad,415500,800000035120,COLLEGE OF NEW ROCHELLE,2790,2790,0,542,528,14,0,0,121,707,2911,1249,506,36,4160,3374.47
2013,66,WESTCHESTER,2,INDEPENDENT,1,PRIVATE,1,4-Year/Grad,415500,800000035120,COLLEGE OF NEW ROCHELLE,2758,2758,0,482,466,16,0,0,111,626,2869,1108,470,22,3977,3280.07
2014,66,WESTCHESTER,2,INDEPENDENT,1,PRIVATE,1,4-Year/Grad,415500,800000035120,COLLEGE OF NEW ROCHELLE,2666,2665,1,416,410,6,0,0,90,568,2756,984,407,31,3740,3121.87
2015,66,WESTCHESTER,2,INDEPENDENT,1,PRIVATE,1,4-Year/Grad,415500,800000035120,COLLEGE OF NEW ROCHELLE,2535,2533,2,443,435,8,0,0,105,510,2640,953,350,17,3593,2991.67
2016,66,WESTCHESTER,2,INDEPENDENT,1,PRIVATE,1,4-Year/Grad,415500,800000035120,COLLEGE OF NEW ROCHELLE,1141,1141,0,303,286,17,0,0,104,567,1245,870,306,17,2115,1572.8
2017,66,WESTCHESTER,2,INDEPENDENT,1,PRIVATE,1,4-Year/Grad,415500,800000035120,COLLEGE OF NEW ROCHELLE,1625,1625,0,242,232,10,0,0,99,597,1724,839,230,2,2563,2043.47
2018,66,WESTCHESTER,2,INDEPENDENT,1,PRIVATE,1,4-Year/Grad,415500,800000035120,COLLEGE OF NEW ROCHELLE,1479,1478,1,216,203,13,0,0,84,463,1563,679,237,5,2242,1820.2
2016,32,BRONX,2,INDEPENDENT,1,PRIVATE,1,4-Year/Grad,415510,800000045844,COLLEGE OF NEW ROCHELLE CO-OP CITY,277,277,0,28,27,1,0,0,0,0,277,28,33,5,305,286.33
2016,31,NEW YORK,2,INDEPENDENT,1,PRIVATE,1,4-Year/Grad,415520,800000066351,COLLEGE OF NEW ROCHELLE - COUNCIL 37 CAMPUS,175,175,0,6,5,1,0,0,0,0,175,6,21,0,181,177
2016,32,BRONX,2,INDEPENDENT,1,PRIVATE,1,4-Year/Grad,415530,800000046589,COLLEGE OF NEW ROCHELLE JOHN CARDINAL O'CONNOR CAMPUS,293,293,0,32,31,1,0,0,0,0,293,32,34,2,325,303.67
2017,32,BRONX,2,INDEPENDENT,1,PRIVATE,1,4-Year/Grad,415530,800000046589,COLLEGE OF NEW ROCHELLE JOHN CARDINAL O'CONNOR CAMPUS,201,201,0,16,14,2,0,0,0,0,201,16,14,0,217,206.33
2018,32,BRONX,2,INDEPENDENT,1,PRIVATE,1,4-Year/Grad,415530,800000046589,COLLEGE OF NEW ROCHELLE JOHN CARDINAL O'CONNOR CAMPUS,134,134,0,32,32,0,0,0,0,0,134,32,27,2,166,144.67
2016,33,KINGS,2,INDEPENDENT,1,PRIVATE,1,4-Year/Grad,415550,800000045434,COLL OF NEW ROCHELLE BROOKLYN CAMPUS,355,355,0,33,33,0,0,0,0,0,355,33,44,4,388,366
2017,33,KINGS,2,INDEPENDENT,1,PRIVATE,1,4-Year/Grad,415550,800000045434,COLL OF NEW ROCHELLE BROOKLYN CAMPUS,227,227,0,40,35,5,0,0,0,0,227,40,12,2,267,240.33
2018,33,KINGS,2,INDEPENDENT,1,PRIVATE,1,4-Year/Grad,415550,800000045434,COLL OF NEW ROCHELLE BROOKLYN CAMPUS,205,205,0,42,35,7,0,0,0,0,205,42,29,2,247,219
2016,31,NEW YORK,2,INDEPENDENT,1,PRIVATE,1,4-Year/Grad,415560,800000047063,COLL NEW ROCHELLE ROSA PARKS CAMPUS,249,249,0,24,24,0,0,0,0,0,249,24,39,4,273,257
2017,31,NEW YORK,2,INDEPENDENT,1,PRIVATE,1,4-Year/Grad,415560,800000047063,COLL NEW ROCHELLE ROSA PARKS CAMPUS,171,171,0,16,16,0,0,0,0,0,171,16,13,0,187,176.33
2018,31,NEW YORK,2,INDEPENDENT,1,PRIVATE,1,4-Year/Grad,415560,800000047063,COLL NEW ROCHELLE ROSA PARKS CAMPUS,186,186,0,37,32,5,0,0,0,0,186,37,18,1,223,198.33
2010,01,ALBANY,2,INDEPENDENT,1,PRIVATE,1,4-Year/Grad,416500,800000055585,COLLEGE OF SAINT ROSE,2846,2846,0,202,144,58,0,0,875,1207,3721,1409,639,1,5130,4271.13
2011,01,ALBANY,2,INDEPENDENT,1,PRIVATE,1,4-Year/Grad,416500,800000055585,COLLEGE OF SAINT ROSE,2764,2764,0,167,126,41,0,0,832,1100,3596,1267,595,0,4863,4091.67
2012,01,ALBANY,2,INDEPENDENT,1,PRIVATE,1,4-Year/Grad,416500,800000055585,COLLEGE OF SAINT ROSE,2721,2721,0,160,114,46,0,0,750,1067,3471,1227,590,0,4698,3951.13
2013,01,ALBANY,2,INDEPENDENT,1,PRIVATE,1,4-Year/Grad,416500,800000055585,COLLEGE OF SAINT ROSE,2664,2663,1,420,127,293,0,0,639,1010,3303,1430,619,2,4733,3847
2014,01,ALBANY,2,INDEPENDENT,1,PRIVATE,1,4-Year/Grad,416500,800000055585,COLLEGE OF SAINT ROSE,2532,2507,25,357,105,252,0,0,654,832,3186,1189,534,0,4375,3637.8
2015,01,ALBANY,2,INDEPENDENT,1,PRIVATE,1,4-Year/Grad,416500,800000055585,COLLEGE OF SAINT ROSE,2540,2535,5,392,91,301,0,0,645,1073,3185,1465,631,1,4650,3744.87
2016,01,ALBANY,2,INDEPENDENT,1,PRIVATE,1,4-Year/Grad,416500,800000055585,COLLEGE OF SAINT ROSE,2510,2510,0,323,71,252,0,0,575,1034,3085,1357,641,0,4442,3606.27
2017,01,ALBANY,2,INDEPENDENT,1,PRIVATE,1,4-Year/Grad,416500,800000055585,COLLEGE OF SAINT ROSE,2426,2425,1,368,65,303,0,0,418,1009,2844,1377,577,0,4221,3370.27
2018,01,ALBANY,2,INDEPENDENT,1,PRIVATE,1,4-Year/Grad,416500,800000055585,COLLEGE OF SAINT ROSE,2403,2403,0,87,67,20,0,0,429,1074,2832,1161,616,1,3993,3290.6
2019,01,ALBANY,2,INDEPENDENT,1,PRIVATE,1,4-Year/Grad,416500,800000055585,COLLEGE OF SAINT ROSE,2363,2363,0,70,46,24,0,0,430,1141,2793,1211,640,0,4004,3272.73
2010,31,NEW YORK,2,INDEPENDENT,1,PRIVATE,1,4-Year/Grad,418000,800000047082,COLUMBIA UNIVERSITY,7116,6923,193,1829,1012,817,2494,27,12010,3230,21620,5086,1375,17,26706,23532.47
2011,31,NEW YORK,2,INDEPENDENT,1,PRIVATE,1,4-Year/Grad,418000,800000047082,COLUMBIA UNIVERSITY,7320,7102,218,1660,1000,660,2467,22,12331,3545,22118,5227,1390,37,27345,24098.13
2012,31,NEW YORK,2,INDEPENDENT,1,PRIVATE,1,4-Year/Grad,418000,800000047082,COLUMBIA UNIVERSITY,7456,7230,226,1246,561,685,2478,25,12471,4121,22405,5392,1427,0,27797,24478.73
2013,31,NEW YORK,2,INDEPENDENT,1,PRIVATE,1,4-Year/Grad,418000,800000047082,COLUMBIA UNIVERSITY,7552,7308,244,1211,589,622,2382,18,13125,4084,23059,5313,1473,36,28372,25103.47
2014,31,NEW YORK,2,INDEPENDENT,1,PRIVATE,1,4-Year/Grad,418000,800000047082,COLUMBIA UNIVERSITY,7876,7558,318,1126,596,530,2378,12,13529,4244,23783,5382,1502,33,29165,25860.73
2015,31,NEW YORK,2,INDEPENDENT,1,PRIVATE,1,4-Year/Grad,418000,800000047082,COLUMBIA UNIVERSITY,8108,7624,484,1424,613,811,2401,24,13572,4142,24081,5590,1470,28,29671,26222.07
2016,31,NEW YORK,2,INDEPENDENT,1,PRIVATE,1,4-Year/Grad,418000,800000047082,COLUMBIA UNIVERSITY,8060,7592,468,1371,581,790,2467,35,14584,4367,25111,5773,1522,24,30884,27328.8
2017,31,NEW YORK,2,INDEPENDENT,1,PRIVATE,1,4-Year/Grad,418000,800000047082,COLUMBIA UNIVERSITY,8052,7592,460,1330,578,752,2572,62,15242,4621,25866,6013,1436,40,31879,28182.53
2018,31,NEW YORK,2,INDEPENDENT,1,PRIVATE,1,4-Year/Grad,418000,800000047082,COLUMBIA UNIVERSITY,8532,7809,723,1259,552,707,2668,82,15755,4551,26955,5892,1450,41,32847,29227.87
2019,31,NEW YORK,2,INDEPENDENT,1,PRIVATE,1,4-Year/Grad,418000,800000047082,COLUMBIA UNIVERSITY,7925,7714,211,726,521,205,2714,26,16588,5108,27227,5860,1434,31,33087,29522.6
2010,66,WESTCHESTER,2,INDEPENDENT,1,PRIVATE,1,4-Year/Grad,418500,800000035634,CONCORDIA COLLEGE,669,668,1,83,45,38,0,0,0,0,669,83,138,0,752,696.67
2011,66,WESTCHESTER,2,INDEPENDENT,1,PRIVATE,1,4-Year/Grad,418500,800000035634,CONCORDIA COLLEGE,718,715,3,101,45,56,0,0,4,2,722,103,138,0,825,756.47
2012,66,WESTCHESTER,2,INDEPENDENT,1,PRIVATE,1,4-Year/Grad,418500,800000035634,CONCORDIA COLLEGE,749,747,2,80,51,29,0,0,34,3,783,83,162,0,866,810.87
2013,66,WESTCHESTER,2,INDEPENDENT,1,PRIVATE,1,4-Year/Grad,418500,800000035634,CONCORDIA COLLEGE,814,812,2,73,68,5,0,0,56,10,870,83,153,0,953,898.33
2016,66,WESTCHESTER,2,INDEPENDENT,1,PRIVATE,1,4-Year/Grad,418500,800000035634,CONCORDIA COLLEGE,812,812,0,117,70,47,0,0,224,32,1036,149,139,1,1185,1087.8
2017,66,WESTCHESTER,2,INDEPENDENT,1,PRIVATE,1,4-Year/Grad,418500,800000035634,CONCORDIA COLLEGE,1022,1017,5,96,68,28,0,0,357,122,1379,218,148,0,1597,1459.8
2018,66,WESTCHESTER,2,INDEPENDENT,1,PRIVATE,1,4-Year/Grad,418500,800000035634,CONCORDIA COLLEGE,1123,1120,3,116,96,20,0,0,381,135,1504,251,147,0,1755,1596.67
2019,66,WESTCHESTER,2,INDEPENDENT,1,PRIVATE,1,4-Year/Grad,418500,800000035634,CONCORDIA COLLEGE,1120,1114,6,149,139,10,0,0,446,134,1566,283,113,0,1849,1669.27
2010,31,NEW YORK,2,INDEPENDENT,1,PRIVATE,1,4-Year/Grad,419000,800000047356,COOPER UNION FOR THE ADVANCEMENT OF SCIENCE AND ART,902,888,14,8,3,5,0,0,65,25,967,33,214,0,1000,979.67
2011,31,NEW YORK,2,INDEPENDENT,1,PRIVATE,1,4-Year/Grad,419000,800000047356,COOPER UNION FOR THE ADVANCEMENT OF SCIENCE AND ART,902,886,16,25,1,24,0,0,44,17,946,42,184,0,988,961.13
2012,31,NEW YORK,2,INDEPENDENT,1,PRIVATE,1,4-Year/Grad,419000,800000047356,COOPER UNION FOR THE ADVANCEMENT OF SCIENCE AND ART,862,848,14,18,7,11,0,0,41,18,903,36,192,0,939,916.2
2013,31,NEW YORK,2,INDEPENDENT,1,PRIVATE,1,4-Year/Grad,419000,800000047356,COOPER UNION FOR THE ADVANCEMENT OF SCIENCE AND ART,863,850,13,5,1,4,0,0,40,12,903,17,192,4,920,909.47
2014,31,NEW YORK,2,INDEPENDENT,1,PRIVATE,1,4-Year/Grad,419000,800000047356,COOPER UNION FOR THE ADVANCEMENT OF SCIENCE AND ART,865,846,19,11,9,2,0,0,53,20,918,31,210,0,949,929.67
2015,31,NEW YORK,2,INDEPENDENT,1,PRIVATE,1,4-Year/Grad,419000,800000047356,COOPER UNION FOR THE ADVANCEMENT OF SCIENCE AND ART,893,870,23,6,3,3,0,28,45,34,938,68,233,1,1006,964.8
2017,31,NEW YORK,2,INDEPENDENT,1,PRIVATE,1,4-Year/Grad,419000,800000047356,COOPER UNION FOR THE ADVANCEMENT OF SCIENCE AND ART,859,846,13,9,8,1,0,0,48,30,907,39,191,1,946,922
2018,31,NEW YORK,2,INDEPENDENT,1,PRIVATE,1,4-Year/Grad,419000,800000047356,COOPER UNION FOR THE ADVANCEMENT OF SCIENCE AND ART,856,844,12,2,1,1,0,0,43,51,899,53,216,0,952,920.07
2019,31,NEW YORK,2,INDEPENDENT,1,PRIVATE,1,4-Year/Grad,419000,800000047356,COOPER UNION FOR THE ADVANCEMENT OF SCIENCE AND ART,854,842,12,3,2,1,0,0,52,43,906,46,198,0,952,924.2
2010,61,TOMPKINS,2,INDEPENDENT,1,PRIVATE,1,4-Year/Grad,419510,800000036397,CORNELL UNIVERSITY,8353,8335,18,4,4,0,611,0,4393,34,13357,38,2078,0,13395,13371.93
2011,61,TOMPKINS,2,INDEPENDENT,1,PRIVATE,1,4-Year/Grad,419510,800000036397,CORNELL UNIVERSITY,8541,8516,25,6,6,0,597,0,4451,34,13589,40,2198,0,13629,13604.6
2012,61,TOMPKINS,2,INDEPENDENT,1,PRIVATE,1,4-Year/Grad,419510,800000036397,CORNELL UNIVERSITY,8592,8563,29,5,5,0,587,0,4639,26,13818,31,2137,0,13849,13830.07
2013,61,TOMPKINS,2,INDEPENDENT,1,PRIVATE,1,4-Year/Grad,419510,800000036397,CORNELL UNIVERSITY,8639,8596,43,6,6,0,591,0,4515,18,13745,24,2141,0,13769,13754.2
2014,61,TOMPKINS,2,INDEPENDENT,1,PRIVATE,1,4-Year/Grad,419510,800000036397,CORNELL UNIVERSITY,8612,8580,32,8,8,0,584,0,4797,18,13993,26,2112,0,14019,14002.87
2015,61,TOMPKINS,2,INDEPENDENT,1,PRIVATE,1,4-Year/Grad,419510,800000036397,CORNELL UNIVERSITY,8643,8607,36,6,6,0,609,0,4914,22,14166,28,2095,0,14194,14176.8
2016,61,TOMPKINS,2,INDEPENDENT,1,PRIVATE,1,4-Year/Grad,419510,800000036397,CORNELL UNIVERSITY,8778,8758,20,5,5,0,619,0,4909,28,14306,33,2229,1,14339,14318.87
2017,61,TOMPKINS,2,INDEPENDENT,1,PRIVATE,1,4-Year/Grad,419510,800000036397,CORNELL UNIVERSITY,8988,8974,14,5,5,0,629,0,5027,33,14644,38,2231,0,14682,14658.87
2018,61,TOMPKINS,2,INDEPENDENT,1,PRIVATE,1,4-Year/Grad,419510,800000036397,CORNELL UNIVERSITY,9204,9192,12,3,3,0,618,0,5205,38,15027,41,2203,0,15068,15043.2
2019,61,TOMPKINS,2,INDEPENDENT,1,PRIVATE,1,4-Year/Grad,419510,800000036397,CORNELL UNIVERSITY,9160,9148,12,2,2,0,626,0,5548,43,15334,45,2035,0,15379,15351.87
2010,31,NEW YORK,2,INDEPENDENT,1,PRIVATE,1,4-Year/Grad,419520,800000047866,CORNELL UNIV MEDICAL CAMPUS,0,0,0,0,0,0,433,0,612,73,1045,73,0,0,1118,1074.2
2011,31,NEW YORK,2,INDEPENDENT,1,PRIVATE,1,4-Year/Grad,419520,800000047866,CORNELL UNIV MEDICAL CAMPUS,0,0,0,0,0,0,417,0,556,36,973,36,0,0,1009,987.4
2012,31,NEW YORK,2,INDEPENDENT,1,PRIVATE,1,4-Year/Grad,419520,800000047866,CORNELL UNIV MEDICAL CAMPUS,0,0,0,0,0,0,407,0,582,38,989,38,0,0,1027,1004.2
2013,31,NEW YORK,2,INDEPENDENT,1,PRIVATE,1,4-Year/Grad,419520,800000047866,CORNELL UNIV MEDICAL CAMPUS,0,0,0,0,0,0,417,0,599,28,1016,28,0,0,1044,1027.2
2014,31,NEW YORK,2,INDEPENDENT,1,PRIVATE,1,4-Year/Grad,419520,800000047866,CORNELL UNIV MEDICAL CAMPUS,0,0,0,0,0,0,406,0,617,0,1023,0,0,0,1023,1023
2015,31,NEW YORK,2,INDEPENDENT,1,PRIVATE,1,4-Year/Grad,419520,800000047866,CORNELL UNIV MEDICAL CAMPUS,0,0,0,0,0,0,423,0,613,0,1036,0,0,0,1036,1036
2016,31,NEW YORK,2,INDEPENDENT,1,PRIVATE,1,4-Year/Grad,419520,800000047866,CORNELL UNIV MEDICAL CAMPUS,0,0,0,0,0,0,409,0,660,0,1069,0,0,0,1069,1069
2017,31,NEW YORK,2,INDEPENDENT,1,PRIVATE,1,4-Year/Grad,419520,800000047866,CORNELL UNIV MEDICAL CAMPUS,0,0,0,0,0,0,406,0,701,0,1107,0,0,0,1107,1107
2018,31,NEW YORK,2,INDEPENDENT,1,PRIVATE,1,4-Year/Grad,419520,800000047866,CORNELL UNIV MEDICAL CAMPUS,0,0,0,0,0,0,435,0,813,0,1248,0,0,0,1248,1248
2019,31,NEW YORK,2,INDEPENDENT,1,PRIVATE,1,4-Year/Grad,419520,800000047866,CORNELL UNIV MEDICAL CAMPUS,0,0,0,0,0,0,442,0,885,0,1327,0,0,0,1327,1327
2016,31,NEW YORK,2,INDEPENDENT,1,PRIVATE,1,4-Year/Grad,419530,800000084405,CORNELL UNIVERSITY - CORNELLNYC TECH CAMPUS,0,0,0,0,0,0,0,0,166,0,166,0,0,0,166,166
2017,31,NEW YORK,2,INDEPENDENT,1,PRIVATE,1,4-Year/Grad,419530,800000084405,CORNELL UNIVERSITY - CORNELLNYC TECH CAMPUS,0,0,0,0,0,0,0,0,261,0,261,0,0,0,261,261
2018,31,NEW YORK,2,INDEPENDENT,1,PRIVATE,1,4-Year/Grad,419530,800000084405,CORNELL UNIVERSITY - CORNELLNYC TECH CAMPUS,0,0,0,0,0,0,0,0,283,0,283,0,0,0,283,283
2019,31,NEW YORK,2,INDEPENDENT,1,PRIVATE,1,4-Year/Grad,419530,800000084405,CORNELL UNIVERSITY - CORNELLNYC TECH CAMPUS,0,0,0,0,0,0,0,0,355,0,355,0,0,0,355,355
2010,42,ONONDAGA,2,INDEPENDENT,1,PRIVATE,0,2-Year,419800,800000040675,CROUSE-IRVING MEMORIAL HOSPITAL SCHOOL OF NURSING,115,115,0,140,133,7,0,0,0,0,115,140,16,3,255,161.67
2011,42,ONONDAGA,2,INDEPENDENT,1,PRIVATE,0,2-Year,419800,800000040675,CROUSE-IRVING MEMORIAL HOSPITAL SCHOOL OF NURSING,131,131,0,150,150,0,0,0,0,0,131,150,21,4,281,181
2012,42,ONONDAGA,2,INDEPENDENT,1,PRIVATE,0,2-Year,419800,800000040675,CROUSE-IRVING MEMORIAL HOSPITAL SCHOOL OF NURSING,159,159,0,171,171,0,0,0,0,0,159,171,25,5,330,216
2013,42,ONONDAGA,2,INDEPENDENT,1,PRIVATE,0,2-Year,419800,800000040675,CROUSE-IRVING MEMORIAL HOSPITAL SCHOOL OF NURSING,155,155,0,183,183,0,0,0,0,0,155,183,12,6,338,216
2014,42,ONONDAGA,2,INDEPENDENT,1,PRIVATE,0,2-Year,419800,800000040675,CROUSE-IRVING MEMORIAL HOSPITAL SCHOOL OF NURSING,121,121,0,224,224,0,0,0,0,0,121,224,9,3,345,195.67
2015,42,ONONDAGA,2,INDEPENDENT,1,PRIVATE,0,2-Year,419800,800000040675,CROUSE-IRVING MEMORIAL HOSPITAL SCHOOL OF NURSING,122,122,0,178,178,0,0,0,0,0,122,178,9,12,300,181.33
2016,42,ONONDAGA,2,INDEPENDENT,1,PRIVATE,0,2-Year,419800,800000040675,CROUSE-IRVING MEMORIAL HOSPITAL SCHOOL OF NURSING,65,65,0,165,164,1,0,0,0,0,65,165,14,0,230,120
2017,42,ONONDAGA,2,INDEPENDENT,1,PRIVATE,0,2-Year,419800,800000040675,CROUSE-IRVING MEMORIAL HOSPITAL SCHOOL OF NURSING,93,93,0,172,172,0,0,0,0,0,93,172,20,3,265,150.33
2018,42,ONONDAGA,2,INDEPENDENT,1,PRIVATE,0,2-Year,419800,800000040675,CROUSE-IRVING MEMORIAL HOSPITAL SCHOOL OF NURSING,81,81,0,166,166,0,0,0,0,0,81,166,13,6,247,136.33
2019,42,ONONDAGA,2,INDEPENDENT,1,PRIVATE,0,2-Year,419800,800000040675,CROUSE-IRVING MEMORIAL HOSPITAL SCHOOL OF NURSING,70,70,0,146,146,0,0,0,0,0,70,146,12,1,216,118.67
2010,13,DUTCHESS,2,INDEPENDENT,1,PRIVATE,1,4-Year/Grad,420000,800000053384,CULINARY INSTITUTE OF AMERICA 697,2491,2491,0,0,0,0,0,0,0,0,2491,0,401,0,2491,2491
2011,13,DUTCHESS,2,INDEPENDENT,1,PRIVATE,1,4-Year/Grad,420000,800000053384,CULINARY INSTITUTE OF AMERICA 697,2480,2480,0,0,0,0,0,0,0,0,2480,0,427,0,2480,2480
2012,13,DUTCHESS,2,INDEPENDENT,1,PRIVATE,1,4-Year/Grad,420000,800000053384,CULINARY INSTITUTE OF AMERICA 697,2421,2421,0,0,0,0,0,0,0,0,2421,0,515,0,2421,2421
2013,13,DUTCHESS,2,INDEPENDENT,1,PRIVATE,1,4-Year/Grad,420000,800000053384,CULINARY INSTITUTE OF AMERICA 697,2387,2387,0,0,0,0,0,0,0,0,2387,0,441,0,2387,2387
2014,13,DUTCHESS,2,INDEPENDENT,1,PRIVATE,1,4-Year/Grad,420000,800000053384,CULINARY INSTITUTE OF AMERICA 697,2347,2347,0,0,0,0,0,0,0,0,2347,0,422,0,2347,2347
2015,13,DUTCHESS,2,INDEPENDENT,1,PRIVATE,1,4-Year/Grad,420000,800000053384,CULINARY INSTITUTE OF AMERICA 697,2411,2411,0,0,0,0,0,0,0,0,2411,0,480,0,2411,2411
2016,13,DUTCHESS,2,INDEPENDENT,1,PRIVATE,1,4-Year/Grad,420000,800000053384,CULINARY INSTITUTE OF AMERICA 697,2351,2351,0,0,0,0,0,0,0,0,2351,0,410,0,2351,2351
2017,13,DUTCHESS,2,INDEPENDENT,1,PRIVATE,1,4-Year/Grad,420000,800000053384,CULINARY INSTITUTE OF AMERICA 697,2595,2595,0,0,0,0,0,0,0,0,2595,0,369,0,2595,2595
2018,13,DUTCHESS,2,INDEPENDENT,1,PRIVATE,1,4-Year/Grad,420000,800000053384,CULINARY INSTITUTE OF AMERICA 697,2418,2418,0,0,0,0,0,0,22,0,2440,0,402,0,2440,2440
2019,13,DUTCHESS,2,INDEPENDENT,1,PRIVATE,1,4-Year/Grad,420000,800000053384,CULINARY INSTITUTE OF AMERICA 697,2459,2459,0,0,0,0,0,0,67,0,2526,0,527,0,2526,2526
2010,14,ERIE,2,INDEPENDENT,1,PRIVATE,1,4-Year/Grad,420500,800000053059,DAEMEN COLLEGE,1545,1542,3,550,255,295,98,10,469,233,2112,793,441,132,2905,2392.53
2011,14,ERIE,2,INDEPENDENT,1,PRIVATE,1,4-Year/Grad,420500,800000053059,DAEMEN COLLEGE,1654,1652,2,502,220,282,121,12,459,202,2234,716,435,0,2950,2486.93
2012,14,ERIE,2,INDEPENDENT,1,PRIVATE,1,4-Year/Grad,420500,800000053059,DAEMEN COLLEGE,1665,1665,0,535,229,306,133,14,404,201,2202,750,438,1,2952,2466.33
2013,14,ERIE,2,INDEPENDENT,1,PRIVATE,1,4-Year/Grad,420500,800000053059,DAEMEN COLLEGE,1720,1719,1,436,252,184,130,10,381,194,2231,640,409,2,2871,2457.93
2014,14,ERIE,2,INDEPENDENT,1,PRIVATE,1,4-Year/Grad,420500,800000053059,DAEMEN COLLEGE,1677,1676,1,368,289,79,139,11,414,191,2230,570,419,1,2800,2433.47
2015,14,ERIE,2,INDEPENDENT,1,PRIVATE,1,4-Year/Grad,420500,800000053059,DAEMEN COLLEGE,1678,1676,2,352,292,60,144,7,409,177,2231,536,384,0,2767,2421.93
2016,14,ERIE,2,INDEPENDENT,1,PRIVATE,1,4-Year/Grad,420500,800000053059,DAEMEN COLLEGE,1621,1621,0,372,263,109,128,3,487,149,2236,524,392,0,2760,2420.8
2017,14,ERIE,2,INDEPENDENT,1,PRIVATE,1,4-Year/Grad,420500,800000053059,DAEMEN COLLEGE,1560,1560,0,242,209,33,149,0,471,214,2180,456,387,0,2636,2346.27
2018,14,ERIE,2,INDEPENDENT,1,PRIVATE,1,4-Year/Grad,420500,800000053059,DAEMEN COLLEGE,1495,1495,0,244,217,27,124,0,443,268,2062,512,338,1,2574,2250.53
2019,14,ERIE,2,INDEPENDENT,1,PRIVATE,1,4-Year/Grad,420500,800000053059,DAEMEN COLLEGE,1480,1479,1,229,200,29,140,0,497,257,2117,486,412,0,2603,2296.13
2010,50,ROCKLAND,2,INDEPENDENT,1,PRIVATE,1,4-Year/Grad,421000,800000039214,DOMINICAN COLL OF BLAUVELT,1369,1367,2,310,280,30,40,110,107,134,1516,554,322,0,2070,1716.93
2011,50,ROCKLAND,2,INDEPENDENT,1,PRIVATE,1,4-Year/Grad,421000,800000039214,DOMINICAN COLL OF BLAUVELT,1377,1376,1,266,233,33,25,143,87,160,1489,569,352,0,2058,1698.87
2012,50,ROCKLAND,2,INDEPENDENT,1,PRIVATE,1,4-Year/Grad,421000,800000039214,DOMINICAN COLL OF BLAUVELT,1357,1357,0,280,202,78,29,178,86,163,1472,621,293,0,2093,1701.73
2013,50,ROCKLAND,2,INDEPENDENT,1,PRIVATE,1,4-Year/Grad,421000,800000039214,DOMINICAN COLL OF BLAUVELT,1280,1280,0,302,225,77,54,168,107,142,1441,612,286,0,2053,1665.67
2014,50,ROCKLAND,2,INDEPENDENT,1,PRIVATE,1,4-Year/Grad,421000,800000039214,DOMINICAN COLL OF BLAUVELT,1269,1269,0,364,205,159,75,167,109,146,1453,677,289,1,2130,1699.53
2015,50,ROCKLAND,2,INDEPENDENT,1,PRIVATE,1,4-Year/Grad,421000,800000039214,DOMINICAN COLL OF BLAUVELT,1356,1356,0,374,191,183,67,159,128,155,1551,688,363,2,2239,1801.27
2016,50,ROCKLAND,2,INDEPENDENT,1,PRIVATE,1,4-Year/Grad,421000,800000039214,DOMINICAN COLL OF BLAUVELT,1330,1330,0,303,131,172,66,169,136,163,1532,635,253,0,2167,1765.8
2017,50,ROCKLAND,2,INDEPENDENT,1,PRIVATE,1,4-Year/Grad,421000,800000039214,DOMINICAN COLL OF BLAUVELT,1271,1271,0,393,142,251,71,193,104,161,1446,747,229,0,2193,1718.6
2018,50,ROCKLAND,2,INDEPENDENT,1,PRIVATE,1,4-Year/Grad,421000,800000039214,DOMINICAN COLL OF BLAUVELT,1304,1304,0,360,129,231,79,158,119,150,1502,668,299,0,2170,1745.2
2019,50,ROCKLAND,2,INDEPENDENT,1,PRIVATE,1,4-Year/Grad,421000,800000039214,DOMINICAN COLL OF BLAUVELT,1268,1268,0,389,93,296,83,133,118,157,1469,679,293,0,2148,1714.67
2010,58,SUFFOLK,2,INDEPENDENT,1,PRIVATE,1,4-Year/Grad,421500,800000037079,DOWLING COLLEGE,2114,2110,4,1138,444,694,0,0,721,1225,2835,2363,459,13,5198,3704.33
2011,58,SUFFOLK,2,INDEPENDENT,1,PRIVATE,1,4-Year/Grad,421500,800000037079,DOWLING COLLEGE,1910,1900,10,973,397,576,0,0,502,1031,2412,2004,345,13,4416,3148.73
2012,58,SUFFOLK,2,INDEPENDENT,1,PRIVATE,1,4-Year/Grad,421500,800000037079,DOWLING COLLEGE,1794,1785,9,746,347,399,0,0,396,770,2190,1516,374,14,3706,2746.67
2013,58,SUFFOLK,2,INDEPENDENT,1,PRIVATE,1,4-Year/Grad,421500,800000037079,DOWLING COLLEGE,1439,1424,15,859,268,591,0,0,282,602,1721,1461,235,11,3182,2248.13
2014,58,SUFFOLK,2,INDEPENDENT,1,PRIVATE,1,4-Year/Grad,421500,800000037079,DOWLING COLLEGE,1087,1080,7,696,201,495,0,0,211,459,1298,1155,182,6,2453,1713.6
2015,58,SUFFOLK,2,INDEPENDENT,1,PRIVATE,1,4-Year/Grad,421500,800000037079,DOWLING COLLEGE,995,995,0,700,159,541,0,0,174,365,1169,1065,210,20,2234,1548.33
2010,14,ERIE,2,INDEPENDENT,1,PRIVATE,1,4-Year/Grad,422000,800000052571,D'YOUVILLE COLLEGE,1608,1608,0,470,294,176,280,21,478,295,2366,786,267,6,3152,2649.07
2011,14,ERIE,2,INDEPENDENT,1,PRIVATE,1,4-Year/Grad,422000,800000052571,D'YOUVILLE COLLEGE,1649,1648,1,452,292,160,356,28,392,268,2397,748,269,3,3145,2666.07
2012,14,ERIE,2,INDEPENDENT,1,PRIVATE,1,4-Year/Grad,422000,800000052571,D'YOUVILLE COLLEGE,1700,1700,0,439,282,157,429,16,301,319,2430,774,280,8,3204,2710.33
2013,14,ERIE,2,INDEPENDENT,1,PRIVATE,1,4-Year/Grad,422000,800000052571,D'YOUVILLE COLLEGE,1614,1614,0,409,241,168,482,36,305,304,2401,749,251,0,3150,2673.33
2014,14,ERIE,2,INDEPENDENT,1,PRIVATE,1,4-Year/Grad,422000,800000052571,D'YOUVILLE COLLEGE,1505,1503,2,458,293,165,497,35,278,294,2280,787,294,16,3067,2564.27
2015,14,ERIE,2,INDEPENDENT,1,PRIVATE,1,4-Year/Grad,422000,800000052571,D'YOUVILLE COLLEGE,1419,1417,2,396,290,106,522,16,315,241,2256,653,232,8,2909,2490.8
2016,14,ERIE,2,INDEPENDENT,1,PRIVATE,1,4-Year/Grad,422000,800000052571,D'YOUVILLE COLLEGE,1431,1430,1,386,323,63,550,7,326,258,2307,651,239,2,2958,2541.67
2017,14,ERIE,2,INDEPENDENT,1,PRIVATE,1,4-Year/Grad,422000,800000052571,D'YOUVILLE COLLEGE,1388,1388,0,479,408,71,527,5,288,334,2203,818,276,1,3021,2498.27
2018,14,ERIE,2,INDEPENDENT,1,PRIVATE,1,4-Year/Grad,422000,800000052571,D'YOUVILLE COLLEGE,1342,1342,0,465,386,79,523,8,281,426,2146,899,243,5,3045,2474.6
2019,14,ERIE,2,INDEPENDENT,1,PRIVATE,1,4-Year/Grad,422000,800000052571,D'YOUVILLE COLLEGE,1256,1253,3,460,387,73,490,7,328,507,2074,974,219,1,3048,2432.93
2010,53,SCHENECTADY,2,INDEPENDENT,1,PRIVATE,0,2-Year,423200,800000038308,ELLIS MEDICINE-THEBELANGER SCHOOL OF NURSING,41,41,0,78,78,0,0,0,0,0,41,78,5,0,119,67
2011,53,SCHENECTADY,2,INDEPENDENT,1,PRIVATE,0,2-Year,423200,800000038308,ELLIS MEDICINE-THEBELANGER SCHOOL OF NURSING,30,30,0,90,90,0,0,0,0,0,30,90,1,0,120,60
2012,53,SCHENECTADY,2,INDEPENDENT,1,PRIVATE,0,2-Year,423200,800000038308,ELLIS MEDICINE-THEBELANGER SCHOOL OF NURSING,45,45,0,87,87,0,0,0,0,0,45,87,1,1,132,74
2013,53,SCHENECTADY,2,INDEPENDENT,1,PRIVATE,0,2-Year,423200,800000038308,ELLIS MEDICINE-THEBELANGER SCHOOL OF NURSING,38,38,0,85,85,0,0,0,0,0,38,85,1,1,123,66.33
2014,53,SCHENECTADY,2,INDEPENDENT,1,PRIVATE,0,2-Year,423200,800000038308,ELLIS MEDICINE-THEBELANGER SCHOOL OF NURSING,41,41,0,86,86,0,0,0,0,0,41,86,1,3,127,69.67
2015,53,SCHENECTADY,2,INDEPENDENT,1,PRIVATE,0,2-Year,423200,800000038308,ELLIS MEDICINE-THEBELANGER SCHOOL OF NURSING,32,32,0,95,95,0,0,0,0,0,32,95,1,1,127,63.67
2016,53,SCHENECTADY,2,INDEPENDENT,1,PRIVATE,0,2-Year,423200,800000038308,ELLIS MEDICINE-THEBELANGER SCHOOL OF NURSING,39,39,0,80,80,0,0,0,0,0,39,80,0,1,119,65.67
2017,53,SCHENECTADY,2,INDEPENDENT,1,PRIVATE,0,2-Year,423200,800000038308,ELLIS MEDICINE-THEBELANGER SCHOOL OF NURSING,37,37,0,77,77,0,0,0,0,0,37,77,0,0,114,62.67
2018,53,SCHENECTADY,2,INDEPENDENT,1,PRIVATE,0,2-Year,423200,800000038308,ELLIS MEDICINE-THEBELANGER SCHOOL OF NURSING,21,21,0,84,84,0,0,0,0,0,21,84,0,0,105,49
2019,53,SCHENECTADY,2,INDEPENDENT,1,PRIVATE,0,2-Year,423200,800000038308,ELLIS MEDICINE-THEBELANGER SCHOOL OF NURSING,9,9,0,122,122,0,0,0,0,0,9,122,1,1,131,49.67
2013,24,LIVINGSTON,2,INDEPENDENT,1,PRIVATE,0,2-Year,423400,800000076393,ELIM BIBLE INSTITUTE & COLLEGE,130,95,35,53,22,31,0,0,0,0,130,53,54,7,183,147.67
2014,24,LIVINGSTON,2,INDEPENDENT,1,PRIVATE,0,2-Year,423400,800000076393,ELIM BIBLE INSTITUTE & COLLEGE,115,111,4,35,23,12,0,0,0,0,115,35,38,2,150,126.67
2015,24,LIVINGSTON,2,INDEPENDENT,1,PRIVATE,0,2-Year,423400,800000076393,ELIM BIBLE INSTITUTE & COLLEGE,132,130,2,20,14,6,0,0,0,0,132,20,55,9,152,138.67
2016,24,LIVINGSTON,2,INDEPENDENT,1,PRIVATE,0,2-Year,423400,800000076393,ELIM BIBLE INSTITUTE & COLLEGE,98,98,0,5,5,0,0,0,0,0,98,5,25,0,103,99.67
2017,24,LIVINGSTON,2,INDEPENDENT,1,PRIVATE,0,2-Year,423400,800000076393,ELIM BIBLE INSTITUTE & COLLEGE,94,94,0,3,3,0,0,0,0,0,94,3,33,1,97,95
2018,24,LIVINGSTON,2,INDEPENDENT,1,PRIVATE,0,2-Year,423400,800000076393,ELIM BIBLE INSTITUTE & COLLEGE,93,92,1,20,14,6,0,0,0,0,93,20,30,11,113,99.67
2019,24,LIVINGSTON,2,INDEPENDENT,1,PRIVATE,0,2-Year,423400,800000076393,ELIM BIBLE INSTITUTE & COLLEGE,86,85,1,20,16,4,0,0,0,0,86,20,22,7,106,92.67
2010,07,CHEMUNG,2,INDEPENDENT,1,PRIVATE,1,4-Year/Grad,423500,800000054092,ELMIRA COLLEGE,1225,1153,72,253,226,27,0,0,38,133,1263,386,428,24,1649,1400.53
2011,07,CHEMUNG,2,INDEPENDENT,1,PRIVATE,1,4-Year/Grad,423500,800000054092,ELMIRA COLLEGE,1161,1093,68,228,199,29,0,0,18,84,1179,312,359,30,1491,1288.6
2012,07,CHEMUNG,2,INDEPENDENT,1,PRIVATE,1,4-Year/Grad,423500,800000054092,ELMIRA COLLEGE,1199,1148,51,237,185,52,0,0,3,166,1202,403,368,33,1605,1347.4
2013,07,CHEMUNG,2,INDEPENDENT,1,PRIVATE,1,4-Year/Grad,423500,800000054092,ELMIRA COLLEGE,1189,1156,33,227,160,67,0,0,10,84,1199,311,318,59,1510,1308.27
2014,07,CHEMUNG,2,INDEPENDENT,1,PRIVATE,1,4-Year/Grad,423500,800000054092,ELMIRA COLLEGE,1177,1177,0,188,141,47,0,0,0,117,1177,305,329,2,1482,1286.47
2015,07,CHEMUNG,2,INDEPENDENT,1,PRIVATE,1,4-Year/Grad,423500,800000054092,ELMIRA COLLEGE,1123,1123,0,165,129,36,0,0,5,83,1128,248,255,3,1376,1216.2
2016,07,CHEMUNG,2,INDEPENDENT,1,PRIVATE,1,4-Year/Grad,423500,800000054092,ELMIRA COLLEGE,974,974,0,127,93,34,0,0,8,78,982,205,207,1,1187,1055.53
2017,07,CHEMUNG,2,INDEPENDENT,1,PRIVATE,1,4-Year/Grad,423500,800000054092,ELMIRA COLLEGE,833,833,0,105,75,30,0,0,6,68,839,173,204,1,1012,901.2
2018,07,CHEMUNG,2,INDEPENDENT,1,PRIVATE,1,4-Year/Grad,423500,800000054092,ELMIRA COLLEGE,746,746,0,73,41,32,0,0,1,72,747,145,206,0,892,800.13
2015,33,KINGS,2,INDEPENDENT,1,PRIVATE,0,2-Year,423600,800000073954,ELYON COLLEGE,30,30,0,0,0,0,0,0,0,0,30,0,30,0,30,30
2016,33,KINGS,2,INDEPENDENT,1,PRIVATE,0,2-Year,423600,800000073954,ELYON COLLEGE,24,24,0,2,2,0,0,0,0,0,24,2,24,2,26,24.67
2017,33,KINGS,2,INDEPENDENT,1,PRIVATE,0,2-Year,423600,800000073954,ELYON COLLEGE,26,26,0,0,0,0,0,0,0,0,26,0,26,0,26,26
2018,33,KINGS,2,INDEPENDENT,1,PRIVATE,0,2-Year,423600,800000073954,ELYON COLLEGE,41,41,0,0,0,0,0,0,0,0,41,0,41,0,41,41
2019,33,KINGS,2,INDEPENDENT,1,PRIVATE,0,2-Year,423600,800000073954,ELYON COLLEGE,28,28,0,0,0,0,0,0,0,0,28,0,28,0,28,28
2011,44,ORANGE,2,INDEPENDENT,1,PRIVATE,1,4-Year/Grad,424100,800000070694,FEI TIAN COLLEGE,58,26,32,0,0,0,0,0,0,0,58,0,20,0,58,58
2012,44,ORANGE,2,INDEPENDENT,1,PRIVATE,1,4-Year/Grad,424100,800000070694,FEI TIAN COLLEGE,42,38,4,41,17,24,0,0,0,0,42,41,32,15,83,55.67
2013,44,ORANGE,2,INDEPENDENT,1,PRIVATE,1,4-Year/Grad,424100,800000070694,FEI TIAN COLLEGE,84,84,0,46,20,26,0,0,0,0,84,46,21,28,130,99.33
2014,44,ORANGE,2,INDEPENDENT,1,PRIVATE,1,4-Year/Grad,424100,800000070694,FEI TIAN COLLEGE,105,105,0,33,26,7,0,0,0,0,105,33,23,6,138,116
2015,44,ORANGE,2,INDEPENDENT,1,PRIVATE,1,4-Year/Grad,424100,800000070694,FEI TIAN COLLEGE,106,106,0,33,21,12,0,0,0,0,106,33,26,0,139,117
2016,44,ORANGE,2,INDEPENDENT,1,PRIVATE,1,4-Year/Grad,424100,800000070694,FEI TIAN COLLEGE,111,111,0,26,7,19,0,0,0,0,111,26,30,0,137,119.67
2017,44,ORANGE,2,INDEPENDENT,1,PRIVATE,1,4-Year/Grad,424100,800000070694,FEI TIAN COLLEGE,104,104,0,20,10,10,0,0,12,5,116,25,33,0,141,124.67
2018,44,ORANGE,2,INDEPENDENT,1,PRIVATE,1,4-Year/Grad,424100,800000070694,FEI TIAN COLLEGE,93,93,0,12,5,7,0,0,26,3,119,15,14,0,134,124.2
2019,44,ORANGE,2,INDEPENDENT,1,PRIVATE,1,4-Year/Grad,424100,800000070694,FEI TIAN COLLEGE,97,97,0,2,1,1,0,0,15,22,112,24,23,0,136,121.47
2018,44,ORANGE,2,INDEPENDENT,1,PRIVATE,1,4-Year/Grad,424110,800000090381,FEI TIAN COLLEGE - MIDDLETOWN,20,19,1,8,5,3,0,0,3,0,23,8,9,4,31,25.67
2019,44,ORANGE,2,INDEPENDENT,1,PRIVATE,1,4-Year/Grad,424110,800000090381,FEI TIAN COLLEGE - MIDDLETOWN,38,38,0,9,6,3,0,0,5,0,43,9,13,0,52,46
2010,43,ONTARIO,2,INDEPENDENT,1,PRIVATE,0,2-Year,424200,800000064837,FINGER LAKES HEALTH COLLEGE OF NURSING & HEALTH SCIENCES,22,22,0,45,45,0,0,0,0,0,22,45,0,0,67,37
2011,43,ONTARIO,2,INDEPENDENT,1,PRIVATE,0,2-Year,424200,800000064837,FINGER LAKES HEALTH COLLEGE OF NURSING & HEALTH SCIENCES,18,18,0,63,63,0,0,0,0,0,18,63,1,0,81,39
2012,43,ONTARIO,2,INDEPENDENT,1,PRIVATE,0,2-Year,424200,800000064837,FINGER LAKES HEALTH COLLEGE OF NURSING & HEALTH SCIENCES,15,15,0,98,98,0,0,0,0,0,15,98,3,0,113,47.67
2013,43,ONTARIO,2,INDEPENDENT,1,PRIVATE,0,2-Year,424200,800000064837,FINGER LAKES HEALTH COLLEGE OF NURSING & HEALTH SCIENCES,23,23,0,96,96,0,0,0,0,0,23,96,1,1,119,55
2014,43,ONTARIO,2,INDEPENDENT,1,PRIVATE,0,2-Year,424200,800000064837,FINGER LAKES HEALTH COLLEGE OF NURSING & HEALTH SCIENCES,19,19,0,119,119,0,0,0,0,0,19,119,5,0,138,58.67
2015,43,ONTARIO,2,INDEPENDENT,1,PRIVATE,0,2-Year,424200,800000064837,FINGER LAKES HEALTH COLLEGE OF NURSING & HEALTH SCIENCES,10,10,0,119,119,0,0,0,0,0,10,119,2,0,129,49.67
2016,43,ONTARIO,2,INDEPENDENT,1,PRIVATE,0,2-Year,424200,800000064837,FINGER LAKES HEALTH COLLEGE OF NURSING & HEALTH SCIENCES,6,6,0,130,130,0,0,0,0,0,6,130,1,1,136,49.33
2017,43,ONTARIO,2,INDEPENDENT,1,PRIVATE,0,2-Year,424200,800000064837,FINGER LAKES HEALTH COLLEGE OF NURSING & HEALTH SCIENCES,10,10,0,113,113,0,0,0,0,0,10,113,5,5,123,47.67
2018,43,ONTARIO,2,INDEPENDENT,1,PRIVATE,0,2-Year,424200,800000064837,FINGER LAKES HEALTH COLLEGE OF NURSING & HEALTH SCIENCES,22,22,0,115,115,0,0,0,0,0,22,115,4,0,137,60.33
2019,43,ONTARIO,2,INDEPENDENT,1,PRIVATE,0,2-Year,424200,800000064837,FINGER LAKES HEALTH COLLEGE OF NURSING & HEALTH SCIENCES,19,19,0,42,42,0,0,0,0,0,19,42,0,0,61,33
2010,32,BRONX,2,INDEPENDENT,1,PRIVATE,1,4-Year/Grad,424500,800000046082,FORDHAM UNIV (ROSE HILL-LINCOLN CTR),7529,7519,10,514,414,100,1203,258,2368,2520,11100,3292,1864,24,14392,12382.53
2011,32,BRONX,2,INDEPENDENT,1,PRIVATE,1,4-Year/Grad,424500,800000046082,FORDHAM UNIV (ROSE HILL-LINCOLN CTR),7764,7756,8,514,430,84,1235,260,2490,2173,11489,2947,1962,24,14436,12633.53
2012,32,BRONX,2,INDEPENDENT,1,PRIVATE,1,4-Year/Grad,424500,800000046082,FORDHAM UNIV (ROSE HILL-LINCOLN CTR),7671,7655,16,509,427,82,1205,233,2710,2144,11586,2886,1855,27,14472,12706.47
2013,32,BRONX,2,INDEPENDENT,1,PRIVATE,1,4-Year/Grad,424500,800000046082,FORDHAM UNIV (ROSE HILL-LINCOLN CTR),7663,7636,27,561,456,105,1113,221,2858,2053,11634,2835,1943,22,14469,12730.6
2014,32,BRONX,2,INDEPENDENT,1,PRIVATE,1,4-Year/Grad,424500,800000046082,FORDHAM UNIV (ROSE HILL-LINCOLN CTR),8018,7994,24,503,388,115,1007,215,2882,2070,11907,2788,2229,29,14695,12988.67
2015,32,BRONX,2,INDEPENDENT,1,PRIVATE,1,4-Year/Grad,424500,800000046082,FORDHAM UNIV (ROSE HILL-LINCOLN CTR),8306,8263,43,456,354,102,963,198,2891,2015,12160,2669,2191,19,14829,13197.2
2016,32,BRONX,2,INDEPENDENT,1,PRIVATE,1,4-Year/Grad,424500,800000046082,FORDHAM UNIV (ROSE HILL-LINCOLN CTR),8744,8706,38,427,312,115,996,179,2855,1923,12595,2529,2189,10,15124,13578.13
2017,32,BRONX,2,INDEPENDENT,1,PRIVATE,1,4-Year/Grad,424500,800000046082,FORDHAM UNIV (ROSE HILL-LINCOLN CTR),9077,9037,40,410,293,117,1042,172,2928,1914,13047,2496,2268,11,15543,14018.07
2018,32,BRONX,2,INDEPENDENT,1,PRIVATE,1,4-Year/Grad,424500,800000046082,FORDHAM UNIV (ROSE HILL-LINCOLN CTR),9108,9057,51,448,279,169,1076,177,3228,2019,13412,2644,2285,13,16056,14439.73
2019,32,BRONX,2,INDEPENDENT,1,PRIVATE,1,4-Year/Grad,424500,800000046082,FORDHAM UNIV (ROSE HILL-LINCOLN CTR),9186,9123,63,500,255,245,1091,182,3025,2571,13302,3253,2258,41,16555,14569.87
2010,66,WESTCHESTER,2,INDEPENDENT,1,PRIVATE,1,4-Year/Grad,424530,800000063351,FORDHAM UNIVERSITY - WESTCHESTER CAMPUS,72,71,1,105,102,3,0,0,345,244,417,349,4,4,766,549.6
2011,66,WESTCHESTER,2,INDEPENDENT,1,PRIVATE,1,4-Year/Grad,424530,800000063351,FORDHAM UNIVERSITY - WESTCHESTER CAMPUS,48,48,0,101,94,7,0,0,412,192,460,293,0,0,753,570.47
2012,66,WESTCHESTER,2,INDEPENDENT,1,PRIVATE,1,4-Year/Grad,424530,800000063351,FORDHAM UNIVERSITY - WESTCHESTER CAMPUS,39,36,3,106,79,27,0,0,336,217,375,323,0,0,698,497.13
2013,66,WESTCHESTER,2,INDEPENDENT,1,PRIVATE,1,4-Year/Grad,424530,800000063351,FORDHAM UNIVERSITY - WESTCHESTER CAMPUS,31,26,5,90,75,15,0,0,350,157,381,247,1,1,628,473.8
2014,66,WESTCHESTER,2,INDEPENDENT,1,PRIVATE,1,4-Year/Grad,424530,800000063351,FORDHAM UNIVERSITY - WESTCHESTER CAMPUS,40,40,0,72,63,9,0,0,286,138,326,210,0,0,536,405.2
2015,66,WESTCHESTER,2,INDEPENDENT,1,PRIVATE,1,4-Year/Grad,424530,800000063351,FORDHAM UNIVERSITY - WESTCHESTER CAMPUS,23,23,0,70,61,9,0,0,260,104,283,174,0,1,457,347.93
2016,66,WESTCHESTER,2,INDEPENDENT,1,PRIVATE,1,4-Year/Grad,424530,800000063351,FORDHAM UNIVERSITY - WESTCHESTER CAMPUS,19,19,0,68,59,9,0,0,270,101,289,169,0,0,458,352.07
2017,66,WESTCHESTER,2,INDEPENDENT,1,PRIVATE,1,4-Year/Grad,424530,800000063351,FORDHAM UNIVERSITY - WESTCHESTER CAMPUS,24,24,0,57,49,8,0,0,288,94,312,151,1,3,463,368.6
2018,66,WESTCHESTER,2,INDEPENDENT,1,PRIVATE,1,4-Year/Grad,424530,800000063351,FORDHAM UNIVERSITY - WESTCHESTER CAMPUS,21,18,3,48,38,10,0,0,283,87,304,135,0,1,439,354.8
2019,66,WESTCHESTER,2,INDEPENDENT,1,PRIVATE,1,4-Year/Grad,424530,800000063351,FORDHAM UNIVERSITY - WESTCHESTER CAMPUS,20,18,2,38,26,12,0,0,255,81,275,119,2,1,394,320.07
2010,33,KINGS,2,INDEPENDENT,1,PRIVATE,0,2-Year,425300,800000065113,GAMLA COLLEGE,270,270,0,0,0,0,0,0,0,0,270,0,0,0,270,270
2011,33,KINGS,2,INDEPENDENT,1,PRIVATE,0,2-Year,425300,800000065113,GAMLA COLLEGE,202,202,0,26,26,0,0,0,0,0,202,26,0,26,228,210.67
2012,33,KINGS,2,INDEPENDENT,1,PRIVATE,0,2-Year,425300,800000065113,GAMLA COLLEGE,22,22,0,104,104,0,0,0,0,0,22,104,22,22,126,56.67
2010,31,NEW YORK,2,INDEPENDENT,1,PRIVATE,1,4-Year/Grad,425500,800000065071,GENERAL THEOLOGICAL SEMINARY,0,0,0,0,0,0,67,3,19,31,86,34,0,0,120,99.6
2011,31,NEW YORK,2,INDEPENDENT,1,PRIVATE,1,4-Year/Grad,425500,800000065071,GENERAL THEOLOGICAL SEMINARY,0,0,0,0,0,0,76,2,17,53,93,55,0,0,148,115
2012,31,NEW YORK,2,INDEPENDENT,1,PRIVATE,1,4-Year/Grad,425500,800000065071,GENERAL THEOLOGICAL SEMINARY,0,0,0,0,0,0,55,3,17,44,72,47,0,0,119,90.8
2013,31,NEW YORK,2,INDEPENDENT,1,PRIVATE,1,4-Year/Grad,425500,800000065071,GENERAL THEOLOGICAL SEMINARY,0,0,0,0,0,0,36,5,15,49,51,54,0,0,105,72.6
2014,31,NEW YORK,2,INDEPENDENT,1,PRIVATE,1,4-Year/Grad,425500,800000065071,GENERAL THEOLOGICAL SEMINARY,0,0,0,0,0,0,37,1,16,29,53,30,0,0,83,65
2015,31,NEW YORK,2,INDEPENDENT,1,PRIVATE,1,4-Year/Grad,425500,800000065071,GENERAL THEOLOGICAL SEMINARY,0,0,0,0,0,0,24,1,6,14,30,15,0,0,45,36
2016,31,NEW YORK,2,INDEPENDENT,1,PRIVATE,1,4-Year/Grad,425500,800000065071,GENERAL THEOLOGICAL SEMINARY,0,0,0,0,0,0,24,1,9,14,33,15,0,0,48,39
2018,31,NEW YORK,2,INDEPENDENT,1,PRIVATE,1,4-Year/Grad,425500,800000065071,GENERAL THEOLOGICAL SEMINARY,0,0,0,0,0,0,18,0,10,15,28,15,0,0,43,34
2019,31,NEW YORK,2,INDEPENDENT,1,PRIVATE,1,4-Year/Grad,425500,800000065071,GENERAL THEOLOGICAL SEMINARY,0,0,0,0,0,0,16,0,19,16,35,16,0,0,51,41.4
2017,31,NEW YORK,2,INDEPENDENT,1,PRIVATE,1,4-Year/Grad,425600,800000090090,GLASGOW CALEDONIAN NEW YORK COLLEGE,0,0,0,0,0,0,0,0,0,16,0,16,0,0,16,6.4
2018,31,NEW YORK,2,INDEPENDENT,1,PRIVATE,1,4-Year/Grad,425600,800000090090,GLASGOW CALEDONIAN NEW YORK COLLEGE,0,0,0,0,0,0,0,0,16,41,16,41,0,0,57,32.4
2019,31,NEW YORK,2,INDEPENDENT,1,PRIVATE,1,4-Year/Grad,425600,800000090090,GLASGOW CALEDONIAN NEW YORK COLLEGE,0,0,0,0,0,0,0,0,4,62,4,62,0,0,66,28.8
2010,31,NEW YORK,2,INDEPENDENT,1,PRIVATE,1,4-Year/Grad,425700,800000047839,THE NEW YORK ACADEMY OF ART,0,0,0,0,0,0,0,0,116,2,116,2,0,0,118,116.8
2011,31,NEW YORK,2,INDEPENDENT,1,PRIVATE,1,4-Year/Grad,425700,800000047839,THE NEW YORK ACADEMY OF ART,0,0,0,0,0,0,0,0,101,5,101,5,0,0,106,103
2012,31,NEW YORK,2,INDEPENDENT,1,PRIVATE,1,4-Year/Grad,425700,800000047839,THE NEW YORK ACADEMY OF ART,0,0,0,0,0,0,0,0,106,3,106,3,0,0,109,107.2
2013,31,NEW YORK,2,INDEPENDENT,1,PRIVATE,1,4-Year/Grad,425700,800000047839,THE NEW YORK ACADEMY OF ART,0,0,0,0,0,0,0,0,106,0,106,0,0,0,106,106
2014,31,NEW YORK,2,INDEPENDENT,1,PRIVATE,1,4-Year/Grad,425700,800000047839,THE NEW YORK ACADEMY OF ART,0,0,0,0,0,0,0,0,108,0,108,0,0,0,108,108
2015,31,NEW YORK,2,INDEPENDENT,1,PRIVATE,1,4-Year/Grad,425700,800000047839,THE NEW YORK ACADEMY OF ART,0,0,0,0,0,0,0,0,108,0,108,0,0,0,108,108
2016,31,NEW YORK,2,INDEPENDENT,1,PRIVATE,1,4-Year/Grad,425700,800000047839,THE NEW YORK ACADEMY OF ART,0,0,0,0,0,0,0,0,113,0,113,0,0,0,113,113
2017,31,NEW YORK,2,INDEPENDENT,1,PRIVATE,1,4-Year/Grad,425700,800000047839,THE NEW YORK ACADEMY OF ART,0,0,0,0,0,0,0,0,106,0,106,0,0,0,106,106
2018,31,NEW YORK,2,INDEPENDENT,1,PRIVATE,1,4-Year/Grad,425700,800000047839,THE NEW YORK ACADEMY OF ART,0,0,0,0,0,0,0,0,120,2,120,2,0,0,122,120.8
2010,53,SCHENECTADY,2,INDEPENDENT,1,PRIVATE,1,4-Year/Grad,426100,800000057564,UNION GRADUATE COLLEGE,0,0,0,0,0,0,0,0,205,252,205,252,0,0,457,305.8
2011,53,SCHENECTADY,2,INDEPENDENT,1,PRIVATE,1,4-Year/Grad,426100,800000057564,UNION GRADUATE COLLEGE,0,0,0,0,0,0,0,0,196,231,196,231,0,0,427,288.4
2012,53,SCHENECTADY,2,INDEPENDENT,1,PRIVATE,1,4-Year/Grad,426100,800000057564,UNION GRADUATE COLLEGE,0,0,0,0,0,0,0,0,192,264,192,264,0,0,456,297.6
2013,53,SCHENECTADY,2,INDEPENDENT,1,PRIVATE,1,4-Year/Grad,426100,800000057564,UNION GRADUATE COLLEGE,0,0,0,0,0,0,0,0,148,277,148,277,0,0,425,258.8
2014,53,SCHENECTADY,2,INDEPENDENT,1,PRIVATE,1,4-Year/Grad,426100,800000057564,UNION GRADUATE COLLEGE,0,0,0,0,0,0,0,0,165,272,165,272,0,0,437,273.8
2015,53,SCHENECTADY,2,INDEPENDENT,1,PRIVATE,1,4-Year/Grad,426100,800000057564,UNION GRADUATE COLLEGE,0,0,0,0,0,0,0,0,163,256,163,256,0,0,419,265.4
2010,41,ONEIDA,2,INDEPENDENT,1,PRIVATE,1,4-Year/Grad,426500,800000041448,HAMILTON COLLEGE,1844,1841,3,17,2,15,0,0,0,0,1844,17,467,3,1861,1849.67
2011,41,ONEIDA,2,INDEPENDENT,1,PRIVATE,1,4-Year/Grad,426500,800000041448,HAMILTON COLLEGE,1844,1841,3,20,2,18,0,0,0,0,1844,20,481,13,1864,1850.67
2012,41,ONEIDA,2,INDEPENDENT,1,PRIVATE,1,4-Year/Grad,426500,800000041448,HAMILTON COLLEGE,1868,1866,2,16,1,15,0,0,0,0,1868,16,469,1,1884,1873.33
2013,41,ONEIDA,2,INDEPENDENT,1,PRIVATE,1,4-Year/Grad,426500,800000041448,HAMILTON COLLEGE,1907,1906,1,21,5,16,0,0,0,0,1907,21,491,0,1928,1914
2014,41,ONEIDA,2,INDEPENDENT,1,PRIVATE,1,4-Year/Grad,426500,800000041448,HAMILTON COLLEGE,1894,1890,4,10,0,10,0,0,0,0,1894,10,469,0,1904,1897.33
2015,41,ONEIDA,2,INDEPENDENT,1,PRIVATE,1,4-Year/Grad,426500,800000041448,HAMILTON COLLEGE,1862,1861,1,15,0,15,0,0,0,0,1862,15,473,0,1877,1867
2016,41,ONEIDA,2,INDEPENDENT,1,PRIVATE,1,4-Year/Grad,426500,800000041448,HAMILTON COLLEGE,1868,1866,2,15,1,14,0,0,0,0,1868,15,472,0,1883,1873
2017,41,ONEIDA,2,INDEPENDENT,1,PRIVATE,1,4-Year/Grad,426500,800000041448,HAMILTON COLLEGE,1886,1885,1,15,0,15,0,0,0,0,1886,15,480,0,1901,1891
2018,41,ONEIDA,2,INDEPENDENT,1,PRIVATE,1,4-Year/Grad,426500,800000041448,HAMILTON COLLEGE,1907,1905,2,14,0,14,0,0,0,0,1907,14,481,0,1921,1911.67
2019,41,ONEIDA,2,INDEPENDENT,1,PRIVATE,1,4-Year/Grad,426500,800000041448,HAMILTON COLLEGE,1999,1997,2,13,0,13,0,0,0,0,1999,13,473,0,2012,2003.33
2010,47,OTSEGO,2,INDEPENDENT,1,PRIVATE,1,4-Year/Grad,427500,800000039834,HARTWICK COLLEGE,1487,1487,0,44,29,15,0,0,0,0,1487,44,487,1,1531,1501.67
2011,47,OTSEGO,2,INDEPENDENT,1,PRIVATE,1,4-Year/Grad,427500,800000039834,HARTWICK COLLEGE,1520,1520,0,58,40,18,0,0,0,0,1520,58,489,6,1578,1539.33
2012,47,OTSEGO,2,INDEPENDENT,1,PRIVATE,1,4-Year/Grad,427500,800000039834,HARTWICK COLLEGE,1503,1503,0,55,39,16,0,0,0,0,1503,55,446,3,1558,1521.33
2013,47,OTSEGO,2,INDEPENDENT,1,PRIVATE,1,4-Year/Grad,427500,800000039834,HARTWICK COLLEGE,1576,1576,0,39,31,8,0,0,0,0,1576,39,528,0,1615,1589
2014,47,OTSEGO,2,INDEPENDENT,1,PRIVATE,1,4-Year/Grad,427500,800000039834,HARTWICK COLLEGE,1507,1507,0,33,22,11,0,0,0,0,1507,33,419,11,1540,1518
2015,47,OTSEGO,2,INDEPENDENT,1,PRIVATE,1,4-Year/Grad,427500,800000039834,HARTWICK COLLEGE,1352,1352,0,40,31,9,0,0,0,0,1352,40,292,0,1392,1365.33
2016,47,OTSEGO,2,INDEPENDENT,1,PRIVATE,1,4-Year/Grad,427500,800000039834,HARTWICK COLLEGE,1362,1362,0,34,20,14,0,0,0,0,1362,34,402,1,1396,1373.33
2017,47,OTSEGO,2,INDEPENDENT,1,PRIVATE,1,4-Year/Grad,427500,800000039834,HARTWICK COLLEGE,1178,1178,0,23,16,7,0,0,0,0,1178,23,351,0,1201,1185.67
2018,47,OTSEGO,2,INDEPENDENT,1,PRIVATE,1,4-Year/Grad,427500,800000039834,HARTWICK COLLEGE,1156,1149,7,19,15,4,0,0,0,0,1156,19,407,0,1175,1162.33
2019,47,OTSEGO,2,INDEPENDENT,1,PRIVATE,1,4-Year/Grad,427500,800000039834,HARTWICK COLLEGE,1169,1169,0,24,12,12,0,0,0,0,1169,24,376,0,1193,1177
2010,31,NEW YORK,2,INDEPENDENT,1,PRIVATE,1,4-Year/Grad,428000,800000047870,HEBREW UNION COLLEGE - JEWISH INSTITUTE OF RELIGION,2,0,2,6,0,6,59,0,36,16,97,22,0,0,119,105.4
2011,31,NEW YORK,2,INDEPENDENT,1,PRIVATE,1,4-Year/Grad,428000,800000047870,HEBREW UNION COLLEGE - JEWISH INSTITUTE OF RELIGION,0,0,0,0,0,0,82,2,18,7,100,9,0,0,109,103.6
2012,31,NEW YORK,2,INDEPENDENT,1,PRIVATE,1,4-Year/Grad,428000,800000047870,HEBREW UNION COLLEGE - JEWISH INSTITUTE OF RELIGION,0,0,0,0,0,0,79,3,17,7,96,10,0,0,106,100
2013,31,NEW YORK,2,INDEPENDENT,1,PRIVATE,1,4-Year/Grad,428000,800000047870,HEBREW UNION COLLEGE - JEWISH INSTITUTE OF RELIGION,0,0,0,0,0,0,71,1,8,43,79,44,0,0,123,96.6
2014,31,NEW YORK,2,INDEPENDENT,1,PRIVATE,1,4-Year/Grad,428000,800000047870,HEBREW UNION COLLEGE - JEWISH INSTITUTE OF RELIGION,0,0,0,0,0,0,71,2,10,55,81,57,0,0,138,103.8
2015,31,NEW YORK,2,INDEPENDENT,1,PRIVATE,1,4-Year/Grad,428000,800000047870,HEBREW UNION COLLEGE - JEWISH INSTITUTE OF RELIGION,0,0,0,0,0,0,73,2,14,46,87,48,0,0,135,106.2
2016,31,NEW YORK,2,INDEPENDENT,1,PRIVATE,1,4-Year/Grad,428000,800000047870,HEBREW UNION COLLEGE - JEWISH INSTITUTE OF RELIGION,0,0,0,0,0,0,68,1,9,50,77,51,0,0,128,97.4
2017,31,NEW YORK,2,INDEPENDENT,1,PRIVATE,1,4-Year/Grad,428000,800000047870,HEBREW UNION COLLEGE - JEWISH INSTITUTE OF RELIGION,0,0,0,0,0,0,60,3,21,23,81,26,0,0,107,91.4
2018,31,NEW YORK,2,INDEPENDENT,1,PRIVATE,1,4-Year/Grad,428000,800000047870,HEBREW UNION COLLEGE - JEWISH INSTITUTE OF RELIGION,0,0,0,0,0,0,13,0,74,52,87,52,0,0,139,107.8
2019,31,NEW YORK,2,INDEPENDENT,1,PRIVATE,1,4-Year/Grad,428000,800000047870,HEBREW UNION COLLEGE - JEWISH INSTITUTE OF RELIGION,0,0,0,0,0,0,13,0,82,34,95,34,0,0,129,108.6
2010,31,NEW YORK,2,INDEPENDENT,1,PRIVATE,1,4-Year/Grad,428500,800000047060,HELENE FULD COLLEGE OF NURSING,191,190,1,227,216,11,0,0,0,0,191,227,0,0,418,266.67
2011,31,NEW YORK,2,INDEPENDENT,1,PRIVATE,1,4-Year/Grad,428500,800000047060,HELENE FULD COLLEGE OF NURSING,146,143,3,213,210,3,0,0,0,0,146,213,0,0,359,217
2012,31,NEW YORK,2,INDEPENDENT,1,PRIVATE,1,4-Year/Grad,428500,800000047060,HELENE FULD COLLEGE OF NURSING,141,141,0,176,174,2,0,0,0,0,141,176,0,5,317,199.67
2013,31,NEW YORK,2,INDEPENDENT,1,PRIVATE,1,4-Year/Grad,428500,800000047060,HELENE FULD COLLEGE OF NURSING,175,175,0,162,159,3,0,0,0,0,175,162,7,2,337,229
2014,31,NEW YORK,2,INDEPENDENT,1,PRIVATE,1,4-Year/Grad,428500,800000047060,HELENE FULD COLLEGE OF NURSING,254,254,0,190,190,0,0,0,0,0,254,190,0,0,444,317.33
2015,31,NEW YORK,2,INDEPENDENT,1,PRIVATE,1,4-Year/Grad,428500,800000047060,HELENE FULD COLLEGE OF NURSING,196,196,0,246,246,0,0,0,0,0,196,246,0,0,442,278
2016,31,NEW YORK,2,INDEPENDENT,1,PRIVATE,1,4-Year/Grad,428500,800000047060,HELENE FULD COLLEGE OF NURSING,161,161,0,275,275,0,0,0,0,0,161,275,0,0,436,252.67
2017,31,NEW YORK,2,INDEPENDENT,1,PRIVATE,1,4-Year/Grad,428500,800000047060,HELENE FULD COLLEGE OF NURSING,163,163,0,234,234,0,0,0,0,0,163,234,0,0,397,241
2018,31,NEW YORK,2,INDEPENDENT,1,PRIVATE,1,4-Year/Grad,428500,800000047060,HELENE FULD COLLEGE OF NURSING,188,188,0,303,302,1,0,0,0,0,188,303,0,0,491,289
2019,31,NEW YORK,2,INDEPENDENT,1,PRIVATE,1,4-Year/Grad,428500,800000047060,HELENE FULD COLLEGE OF NURSING,245,245,0,368,368,0,0,0,0,0,245,368,0,0,613,367.67
2010,14,ERIE,2,INDEPENDENT,1,PRIVATE,1,4-Year/Grad,429000,800000052181,HILBERT COLLEGE,866,864,2,190,151,39,0,0,0,0,866,190,249,7,1056,929.33
2011,14,ERIE,2,INDEPENDENT,1,PRIVATE,1,4-Year/Grad,429000,800000052181,HILBERT COLLEGE,914,914,0,166,138,28,0,0,28,0,942,166,222,6,1108,997.33
2012,14,ERIE,2,INDEPENDENT,1,PRIVATE,1,4-Year/Grad,429000,800000052181,HILBERT COLLEGE,878,878,0,144,117,27,0,0,39,3,917,147,179,3,1064,966.2
2013,14,ERIE,2,INDEPENDENT,1,PRIVATE,1,4-Year/Grad,429000,800000052181,HILBERT COLLEGE,884,884,0,136,107,29,0,0,44,6,928,142,188,2,1070,975.73
2014,14,ERIE,2,INDEPENDENT,1,PRIVATE,1,4-Year/Grad,429000,800000052181,HILBERT COLLEGE,842,842,0,105,90,15,0,0,39,13,881,118,168,0,999,921.2
2015,14,ERIE,2,INDEPENDENT,1,PRIVATE,1,4-Year/Grad,429000,800000052181,HILBERT COLLEGE,786,786,0,89,79,10,0,0,42,16,828,105,152,2,933,864.07
2016,14,ERIE,2,INDEPENDENT,1,PRIVATE,1,4-Year/Grad,429000,800000052181,HILBERT COLLEGE,740,739,1,69,51,18,0,0,44,13,784,82,147,0,866,812.2
2017,14,ERIE,2,INDEPENDENT,1,PRIVATE,1,4-Year/Grad,429000,800000052181,HILBERT COLLEGE,680,680,0,60,49,11,0,0,42,4,722,64,167,2,786,743.6
2018,14,ERIE,2,INDEPENDENT,1,PRIVATE,1,4-Year/Grad,429000,800000052181,HILBERT COLLEGE,688,688,0,44,37,7,0,0,29,3,717,47,220,2,764,732.87
2019,14,ERIE,2,INDEPENDENT,1,PRIVATE,1,4-Year/Grad,429000,800000052181,HILBERT COLLEGE,686,686,0,37,25,12,0,0,42,1,728,38,160,1,766,740.73
2010,43,ONTARIO,2,INDEPENDENT,1,PRIVATE,1,4-Year/Grad,429500,800000040571,HOBART & WM SMITH COLLEGES,2161,2136,25,4,2,2,0,0,7,1,2168,5,618,0,2173,2169.73
2011,43,ONTARIO,2,INDEPENDENT,1,PRIVATE,1,4-Year/Grad,429500,800000040571,HOBART & WM SMITH COLLEGES,2225,2208,17,9,4,5,0,0,8,0,2233,9,681,0,2242,2236
2012,43,ONTARIO,2,INDEPENDENT,1,PRIVATE,1,4-Year/Grad,429500,800000040571,HOBART & WM SMITH COLLEGES,2267,2244,23,25,4,21,0,0,8,0,2275,25,600,0,2300,2283.33
2013,43,ONTARIO,2,INDEPENDENT,1,PRIVATE,1,4-Year/Grad,429500,800000040571,HOBART & WM SMITH COLLEGES,2324,2307,17,44,4,40,0,0,4,0,2328,44,638,0,2372,2342.67
2014,43,ONTARIO,2,INDEPENDENT,1,PRIVATE,1,4-Year/Grad,429500,800000040571,HOBART & WM SMITH COLLEGES,2362,2342,20,59,2,57,0,0,4,0,2366,59,643,0,2425,2385.67
2015,43,ONTARIO,2,INDEPENDENT,1,PRIVATE,1,4-Year/Grad,429500,800000040571,HOBART & WM SMITH COLLEGES,2270,2246,24,74,11,63,0,0,7,0,2277,74,631,0,2351,2301.67
2016,43,ONTARIO,2,INDEPENDENT,1,PRIVATE,1,4-Year/Grad,429500,800000040571,HOBART & WM SMITH COLLEGES,2246,2232,14,16,9,7,0,0,9,0,2255,16,581,1,2271,2260.33
2017,43,ONTARIO,2,INDEPENDENT,1,PRIVATE,1,4-Year/Grad,429500,800000040571,HOBART & WM SMITH COLLEGES,2220,2209,11,17,11,6,0,0,7,0,2227,17,634,0,2244,2232.67
2018,43,ONTARIO,2,INDEPENDENT,1,PRIVATE,1,4-Year/Grad,429500,800000040571,HOBART & WM SMITH COLLEGES,2208,2197,11,21,9,12,0,0,12,0,2220,21,611,0,2241,2227
2019,43,ONTARIO,2,INDEPENDENT,1,PRIVATE,1,4-Year/Grad,429500,800000040571,HOBART & WM SMITH COLLEGES,2045,2031,14,16,5,11,0,0,9,0,2054,16,458,0,2070,2059.33
2010,28,NASSAU,2,INDEPENDENT,1,PRIVATE,1,4-Year/Grad,430000,800000049813,HOFSTRA UNIVERSITY-MAIN CAMPUS,6804,6800,4,585,548,37,969,119,1625,1477,9398,2181,1446,4,11579,10231.4
2011,28,NASSAU,2,INDEPENDENT,1,PRIVATE,1,4-Year/Grad,430000,800000049813,HOFSTRA UNIVERSITY-MAIN CAMPUS,6636,6630,6,547,506,41,1076,70,1769,1306,9481,1923,1672,3,11404,10213.73
2012,28,NASSAU,2,INDEPENDENT,1,PRIVATE,1,4-Year/Grad,430000,800000049813,HOFSTRA UNIVERSITY-MAIN CAMPUS,6374,6359,15,519,474,45,1082,36,1862,1150,9318,1705,1484,4,11023,9965.4
2013,28,NASSAU,2,INDEPENDENT,1,PRIVATE,1,4-Year/Grad,430000,800000049813,HOFSTRA UNIVERSITY-MAIN CAMPUS,6378,6361,17,448,387,61,1019,29,1986,1068,9383,1545,1618,4,10928,9971.13
2014,28,NASSAU,2,INDEPENDENT,1,PRIVATE,1,4-Year/Grad,430000,800000049813,HOFSTRA UNIVERSITY-MAIN CAMPUS,6474,6430,44,430,373,57,1060,24,1945,1020,9479,1474,1726,1,10953,10039.93
2015,28,NASSAU,2,INDEPENDENT,1,PRIVATE,1,4-Year/Grad,430000,800000049813,HOFSTRA UNIVERSITY-MAIN CAMPUS,6417,6365,52,407,351,56,1053,21,1843,1073,9313,1501,1668,3,10814,9886.27
2016,28,NASSAU,2,INDEPENDENT,1,PRIVATE,1,4-Year/Grad,430000,800000049813,HOFSTRA UNIVERSITY-MAIN CAMPUS,6497,6462,35,402,348,54,1097,25,1933,1191,9527,1618,1666,1,11145,10147.4
2017,28,NASSAU,2,INDEPENDENT,1,PRIVATE,1,4-Year/Grad,430000,800000049813,HOFSTRA UNIVERSITY-MAIN CAMPUS,6494,6469,25,367,314,53,1126,19,1877,1248,9497,1634,1642,1,11131,10126.13
2018,28,NASSAU,2,INDEPENDENT,1,PRIVATE,1,4-Year/Grad,430000,800000049813,HOFSTRA UNIVERSITY-MAIN CAMPUS,6329,6298,31,372,318,54,1144,31,1858,1137,9331,1540,1562,3,10871,9922.2
2019,28,NASSAU,2,INDEPENDENT,1,PRIVATE,1,4-Year/Grad,430000,800000049813,HOFSTRA UNIVERSITY-MAIN CAMPUS,6156,6116,40,342,284,58,1213,33,1866,1194,9235,1569,1541,1,10804,9839.8
2010,21,HERKIMER,2,INDEPENDENT,1,PRIVATE,1,4-Year/Grad,430500,800000051292,HOLY TRINITY ORTHODOX SEMINARY,29,29,0,54,54,0,0,0,0,0,29,54,0,0,83,47
2011,21,HERKIMER,2,INDEPENDENT,1,PRIVATE,1,4-Year/Grad,430500,800000051292,HOLY TRINITY ORTHODOX SEMINARY,31,31,0,54,54,0,0,0,0,0,31,54,3,0,85,49
2012,21,HERKIMER,2,INDEPENDENT,1,PRIVATE,1,4-Year/Grad,430500,800000051292,HOLY TRINITY ORTHODOX SEMINARY,36,36,0,60,60,0,0,0,0,0,36,60,4,0,96,56
2013,21,HERKIMER,2,INDEPENDENT,1,PRIVATE,1,4-Year/Grad,430500,800000051292,HOLY TRINITY ORTHODOX SEMINARY,32,32,0,42,42,0,0,0,0,0,32,42,0,0,74,46
2014,21,HERKIMER,2,INDEPENDENT,1,PRIVATE,1,4-Year/Grad,430500,800000051292,HOLY TRINITY ORTHODOX SEMINARY,28,28,0,41,41,0,0,0,0,0,28,41,5,0,69,41.67
2015,21,HERKIMER,2,INDEPENDENT,1,PRIVATE,1,4-Year/Grad,430500,800000051292,HOLY TRINITY ORTHODOX SEMINARY,26,26,0,38,38,0,0,0,0,0,26,38,2,3,64,38.67
2016,21,HERKIMER,2,INDEPENDENT,1,PRIVATE,1,4-Year/Grad,430500,800000051292,HOLY TRINITY ORTHODOX SEMINARY,26,26,0,16,16,0,0,0,0,0,26,16,2,1,42,31.33
2010,02,ALLEGANY,2,INDEPENDENT,1,PRIVATE,1,4-Year/Grad,431000,800000055150,HOUGHTON COLLEGE,1196,1194,2,60,29,31,0,0,9,7,1205,67,254,26,1272,1227.8
2011,02,ALLEGANY,2,INDEPENDENT,1,PRIVATE,1,4-Year/Grad,431000,800000055150,HOUGHTON COLLEGE,1187,1187,0,81,26,55,0,0,6,13,1193,94,266,0,1287,1225.2
2012,02,ALLEGANY,2,INDEPENDENT,1,PRIVATE,1,4-Year/Grad,431000,800000055150,HOUGHTON COLLEGE,1086,1084,2,61,29,32,0,0,10,8,1096,69,234,0,1165,1119.53
2013,02,ALLEGANY,2,INDEPENDENT,1,PRIVATE,1,4-Year/Grad,431000,800000055150,HOUGHTON COLLEGE,1023,1023,0,58,24,34,0,0,9,10,1032,68,223,0,1100,1055.33
2014,02,ALLEGANY,2,INDEPENDENT,1,PRIVATE,1,4-Year/Grad,431000,800000055150,HOUGHTON COLLEGE,994,994,0,54,13,41,0,0,23,7,1017,61,253,0,1078,1037.8
2015,02,ALLEGANY,2,INDEPENDENT,1,PRIVATE,1,4-Year/Grad,431000,800000055150,HOUGHTON COLLEGE,995,990,5,62,19,43,0,0,14,6,1009,68,265,1,1077,1032.07
2016,02,ALLEGANY,2,INDEPENDENT,1,PRIVATE,1,4-Year/Grad,431000,800000055150,HOUGHTON COLLEGE,998,998,0,91,36,55,0,0,14,2,1012,93,271,0,1105,1043.13
2017,02,ALLEGANY,2,INDEPENDENT,1,PRIVATE,1,4-Year/Grad,431000,800000055150,HOUGHTON COLLEGE,997,997,0,76,32,44,0,0,10,3,1007,79,267,0,1086,1033.53
2018,02,ALLEGANY,2,INDEPENDENT,1,PRIVATE,1,4-Year/Grad,431000,800000055150,HOUGHTON COLLEGE,963,963,0,82,28,54,0,0,11,2,974,84,254,3,1058,1002.13
2019,02,ALLEGANY,2,INDEPENDENT,1,PRIVATE,1,4-Year/Grad,431000,800000055150,HOUGHTON COLLEGE,883,883,0,62,44,18,0,0,18,11,901,73,296,2,974,926.07
2010,33,KINGS,2,INDEPENDENT,1,PRIVATE,0,2-Year,432500,800000045413,INST OF DESIGN & CONSTRUCTION,75,74,1,64,45,19,0,0,0,0,75,64,16,13,139,96.33
2011,33,KINGS,2,INDEPENDENT,1,PRIVATE,0,2-Year,432500,800000045413,INST OF DESIGN & CONSTRUCTION,58,58,0,66,46,20,0,0,0,0,58,66,5,8,124,80
2012,33,KINGS,2,INDEPENDENT,1,PRIVATE,0,2-Year,432500,800000045413,INST OF DESIGN & CONSTRUCTION,56,56,0,71,54,17,0,0,0,0,56,71,17,11,127,79.67
2013,33,KINGS,2,INDEPENDENT,1,PRIVATE,0,2-Year,432500,800000045413,INST OF DESIGN & CONSTRUCTION,43,43,0,60,42,18,0,0,0,0,43,60,10,2,103,63
2014,33,KINGS,2,INDEPENDENT,1,PRIVATE,0,2-Year,432500,800000045413,INST OF DESIGN & CONSTRUCTION,41,41,0,52,24,28,0,0,0,0,41,52,9,8,93,58.33
2010,66,WESTCHESTER,2,INDEPENDENT,1,PRIVATE,1,4-Year/Grad,433100,800000035119,IONA COLLEGE,3156,3152,4,100,76,24,0,0,309,558,3465,658,871,0,4123,3721.53
2011,66,WESTCHESTER,2,INDEPENDENT,1,PRIVATE,1,4-Year/Grad,433100,800000035119,IONA COLLEGE,3097,3096,1,542,67,475,0,0,276,600,3373,1142,812,0,4515,3793.67
2012,66,WESTCHESTER,2,INDEPENDENT,1,PRIVATE,1,4-Year/Grad,433100,800000035119,IONA COLLEGE,2927,2924,3,539,64,475,0,0,261,518,3188,1057,722,0,4245,3574.87
2013,66,WESTCHESTER,2,INDEPENDENT,1,PRIVATE,1,4-Year/Grad,433100,800000035119,IONA COLLEGE,3110,3106,4,429,60,369,0,0,279,423,3389,852,922,0,4241,3701.2
2014,66,WESTCHESTER,2,INDEPENDENT,1,PRIVATE,1,4-Year/Grad,433100,800000035119,IONA COLLEGE,2994,2993,1,307,59,248,0,0,273,335,3267,642,800,2,3909,3503.33
2015,66,WESTCHESTER,2,INDEPENDENT,1,PRIVATE,1,4-Year/Grad,433100,800000035119,IONA COLLEGE,2959,2958,1,312,60,252,0,0,383,323,3342,635,838,4,3977,3575.2
2016,66,WESTCHESTER,2,INDEPENDENT,1,PRIVATE,1,4-Year/Grad,433100,800000035119,IONA COLLEGE,3069,3066,3,260,54,206,0,0,358,332,3427,592,935,0,4019,3646.47
2017,66,WESTCHESTER,2,INDEPENDENT,1,PRIVATE,1,4-Year/Grad,433100,800000035119,IONA COLLEGE,2949,2948,1,229,41,188,0,0,341,273,3290,502,860,0,3792,3475.53
2018,66,WESTCHESTER,2,INDEPENDENT,1,PRIVATE,1,4-Year/Grad,433100,800000035119,IONA COLLEGE,2961,2955,6,326,50,276,0,0,345,294,3306,620,852,1,3926,3532.27
2019,66,WESTCHESTER,2,INDEPENDENT,1,PRIVATE,1,4-Year/Grad,433100,800000035119,IONA COLLEGE,2709,2702,7,272,41,231,0,0,335,297,3044,569,641,0,3613,3253.47
2010,61,TOMPKINS,2,INDEPENDENT,1,PRIVATE,1,4-Year/Grad,433500,800000036398,ITHACA COLLEGE,6333,6321,12,109,61,48,155,0,292,60,6780,169,1627,33,6949,6840.33
2011,61,TOMPKINS,2,INDEPENDENT,1,PRIVATE,1,4-Year/Grad,433500,800000036398,ITHACA COLLEGE,6173,6159,14,103,69,34,144,0,285,55,6602,158,1637,15,6760,6658.33
2012,61,TOMPKINS,2,INDEPENDENT,1,PRIVATE,1,4-Year/Grad,433500,800000036398,ITHACA COLLEGE,6159,6147,12,122,86,36,163,1,267,47,6589,170,1586,22,6759,6648.87
2013,61,TOMPKINS,2,INDEPENDENT,1,PRIVATE,1,4-Year/Grad,433500,800000036398,ITHACA COLLEGE,6131,6122,9,103,79,24,167,1,264,57,6562,161,1789,13,6723,6619.53
2014,61,TOMPKINS,2,INDEPENDENT,1,PRIVATE,1,4-Year/Grad,433500,800000036398,ITHACA COLLEGE,6012,6003,9,112,82,30,166,1,243,53,6421,166,1560,18,6587,6479.93
2015,61,TOMPKINS,2,INDEPENDENT,1,PRIVATE,1,4-Year/Grad,433500,800000036398,ITHACA COLLEGE,6206,6197,9,117,81,36,167,1,204,74,6577,192,1808,18,6769,6646
2016,61,TOMPKINS,2,INDEPENDENT,1,PRIVATE,1,4-Year/Grad,433500,800000036398,ITHACA COLLEGE,6103,6099,4,118,82,36,174,0,217,66,6494,184,1632,18,6678,6559.73
2017,61,TOMPKINS,2,INDEPENDENT,1,PRIVATE,1,4-Year/Grad,433500,800000036398,ITHACA COLLEGE,5936,5932,4,123,89,34,174,0,212,71,6322,194,1622,25,6516,6391.4
2018,61,TOMPKINS,2,INDEPENDENT,1,PRIVATE,1,4-Year/Grad,433500,800000036398,ITHACA COLLEGE,5991,5985,6,110,87,23,172,0,182,62,6345,172,1670,13,6517,6406.47
2019,61,TOMPKINS,2,INDEPENDENT,1,PRIVATE,1,4-Year/Grad,433500,800000036398,ITHACA COLLEGE,5739,5735,4,113,68,45,165,3,184,62,6088,178,1509,33,6266,6151.67
2010,31,NEW YORK,2,INDEPENDENT,1,PRIVATE,1,4-Year/Grad,434000,800000047358,JEWISH THEOLOGICAL SEMNRY OF AMERICA,158,158,0,18,18,0,130,19,127,64,415,101,45,6,516,454.2
2011,31,NEW YORK,2,INDEPENDENT,1,PRIVATE,1,4-Year/Grad,434000,800000047358,JEWISH THEOLOGICAL SEMNRY OF AMERICA,169,168,1,1,1,0,109,4,157,32,435,37,43,0,472,449.73
2012,31,NEW YORK,2,INDEPENDENT,1,PRIVATE,1,4-Year/Grad,434000,800000047358,JEWISH THEOLOGICAL SEMNRY OF AMERICA,171,171,0,1,0,1,62,8,161,50,394,59,39,1,453,417.53
2013,31,NEW YORK,2,INDEPENDENT,1,PRIVATE,1,4-Year/Grad,434000,800000047358,JEWISH THEOLOGICAL SEMNRY OF AMERICA,163,163,0,0,0,0,95,2,135,54,393,56,35,0,449,415.4
2014,31,NEW YORK,2,INDEPENDENT,1,PRIVATE,1,4-Year/Grad,434000,800000047358,JEWISH THEOLOGICAL SEMNRY OF AMERICA,156,156,0,0,0,0,87,7,45,109,288,116,38,0,404,334.4
2015,31,NEW YORK,2,INDEPENDENT,1,PRIVATE,1,4-Year/Grad,434000,800000047358,JEWISH THEOLOGICAL SEMNRY OF AMERICA,158,158,0,1,1,0,84,8,32,102,274,111,41,1,385,318.33
2016,31,NEW YORK,2,INDEPENDENT,1,PRIVATE,1,4-Year/Grad,434000,800000047358,JEWISH THEOLOGICAL SEMNRY OF AMERICA,157,156,1,0,0,0,92,5,30,58,279,63,43,0,342,304.2
2017,31,NEW YORK,2,INDEPENDENT,1,PRIVATE,1,4-Year/Grad,434000,800000047358,JEWISH THEOLOGICAL SEMNRY OF AMERICA,161,161,0,1,0,1,81,4,27,102,269,107,38,0,376,311.73
2018,31,NEW YORK,2,INDEPENDENT,1,PRIVATE,1,4-Year/Grad,434000,800000047358,JEWISH THEOLOGICAL SEMNRY OF AMERICA,147,146,1,0,0,0,74,6,27,82,248,88,33,0,336,283.2
2019,31,NEW YORK,2,INDEPENDENT,1,PRIVATE,1,4-Year/Grad,434000,800000047358,JEWISH THEOLOGICAL SEMNRY OF AMERICA,143,142,1,1,1,0,75,4,21,91,239,96,38,0,335,277.33
2010,31,NEW YORK,2,INDEPENDENT,1,PRIVATE,1,4-Year/Grad,434500,800000047354,THE JUILLIARD SCHOOL,510,510,0,134,0,134,0,0,297,38,807,172,131,0,979,866.87
2011,31,NEW YORK,2,INDEPENDENT,1,PRIVATE,1,4-Year/Grad,434500,800000047354,THE JUILLIARD SCHOOL,519,519,0,125,1,124,0,0,299,25,818,150,100,0,968,869.67
2012,31,NEW YORK,2,INDEPENDENT,1,PRIVATE,1,4-Year/Grad,434500,800000047354,THE JUILLIARD SCHOOL,507,507,0,106,1,105,0,0,324,21,831,127,108,0,958,874.73
2013,31,NEW YORK,2,INDEPENDENT,1,PRIVATE,1,4-Year/Grad,434500,800000047354,THE JUILLIARD SCHOOL,498,498,0,83,0,83,0,0,328,18,826,101,109,0,927,860.87
2014,31,NEW YORK,2,INDEPENDENT,1,PRIVATE,1,4-Year/Grad,434500,800000047354,THE JUILLIARD SCHOOL,509,509,0,62,1,61,0,0,338,19,847,81,129,0,928,875.27
2015,31,NEW YORK,2,INDEPENDENT,1,PRIVATE,1,4-Year/Grad,434500,800000047354,THE JUILLIARD SCHOOL,490,490,0,76,1,75,0,0,344,20,834,96,110,0,930,867.33
2016,31,NEW YORK,2,INDEPENDENT,1,PRIVATE,1,4-Year/Grad,434500,800000047354,THE JUILLIARD SCHOOL,498,498,0,82,1,81,0,0,340,19,838,101,114,0,939,872.93
2017,31,NEW YORK,2,INDEPENDENT,1,PRIVATE,1,4-Year/Grad,434500,800000047354,THE JUILLIARD SCHOOL,486,486,0,80,0,80,0,0,341,20,827,100,110,0,927,861.67
2018,31,NEW YORK,2,INDEPENDENT,1,PRIVATE,1,4-Year/Grad,434500,800000047354,THE JUILLIARD SCHOOL,487,487,0,98,0,98,0,0,342,15,829,113,122,0,942,867.67
2019,31,NEW YORK,2,INDEPENDENT,1,PRIVATE,1,4-Year/Grad,434500,800000047354,THE JUILLIARD SCHOOL,486,486,0,102,0,102,0,0,354,18,840,120,116,0,960,881.2
2010,68,YATES,2,INDEPENDENT,1,PRIVATE,1,4-Year/Grad,435000,800000034470,KEUKA COLLEGE,1317,1317,0,309,309,0,0,0,127,114,1444,423,270,0,1867,1592.6
2011,68,YATES,2,INDEPENDENT,1,PRIVATE,1,4-Year/Grad,435000,800000034470,KEUKA COLLEGE,1455,1455,0,287,287,0,0,0,152,21,1607,308,265,0,1915,1711.07
2012,68,YATES,2,INDEPENDENT,1,PRIVATE,1,4-Year/Grad,435000,800000034470,KEUKA COLLEGE,1488,1488,0,250,249,1,0,0,193,25,1681,275,245,0,1956,1774.33
2013,68,YATES,2,INDEPENDENT,1,PRIVATE,1,4-Year/Grad,435000,800000034470,KEUKA COLLEGE,1507,1507,0,315,314,1,0,0,202,2,1709,317,231,0,2026,1814.8
2014,68,YATES,2,INDEPENDENT,1,PRIVATE,1,4-Year/Grad,435000,800000034470,KEUKA COLLEGE,1356,1356,0,448,448,0,0,0,194,0,1550,448,220,0,1998,1699.33
2015,68,YATES,2,INDEPENDENT,1,PRIVATE,1,4-Year/Grad,435000,800000034470,KEUKA COLLEGE,1336,1336,0,388,381,7,0,0,203,6,1539,394,318,0,1933,1670.73
2016,68,YATES,2,INDEPENDENT,1,PRIVATE,1,4-Year/Grad,435000,800000034470,KEUKA COLLEGE,1305,1301,4,329,325,4,0,0,199,74,1504,403,365,0,1907,1643.27
2017,68,YATES,2,INDEPENDENT,1,PRIVATE,1,4-Year/Grad,435000,800000034470,KEUKA COLLEGE,1288,1285,3,287,286,1,0,9,181,76,1469,372,367,0,1841,1598.67
2018,68,YATES,2,INDEPENDENT,1,PRIVATE,1,4-Year/Grad,435000,800000034470,KEUKA COLLEGE,1353,1353,0,254,253,1,0,0,159,95,1512,349,330,0,1861,1634.67
2019,68,YATES,2,INDEPENDENT,1,PRIVATE,1,4-Year/Grad,435000,800000034470,KEUKA COLLEGE,1260,1258,2,226,224,2,0,0,119,120,1379,346,299,0,1725,1502.33
2016,42,ONONDAGA,2,INDEPENDENT,1,PRIVATE,1,4-Year/Grad,435010,800000066372,KEUKA-ONONDAGA COMMUNITY COLLEGE BRANCH,24,24,0,31,31,0,0,0,0,0,24,31,0,0,55,34.33
2017,42,ONONDAGA,2,INDEPENDENT,1,PRIVATE,1,4-Year/Grad,435010,800000066372,KEUKA-ONONDAGA COMMUNITY COLLEGE BRANCH,17,17,0,21,21,0,0,0,0,1,17,22,0,0,39,24.4
2018,42,ONONDAGA,2,INDEPENDENT,1,PRIVATE,1,4-Year/Grad,435010,800000066372,KEUKA-ONONDAGA COMMUNITY COLLEGE BRANCH,11,11,0,26,26,0,0,0,0,0,11,26,0,0,37,19.67
2019,42,ONONDAGA,2,INDEPENDENT,1,PRIVATE,1,4-Year/Grad,435010,800000066372,KEUKA-ONONDAGA COMMUNITY COLLEGE BRANCH,13,13,0,6,6,0,0,0,0,0,13,6,0,0,19,15
2016,57,STEUBEN,2,INDEPENDENT,1,PRIVATE,1,4-Year/Grad,435020,800000066371,KEUKA COLLEGE-CORNING CC CAMPUS,22,22,0,19,19,0,0,0,0,0,22,19,0,0,41,28.33
2017,57,STEUBEN,2,INDEPENDENT,1,PRIVATE,1,4-Year/Grad,435020,800000066371,KEUKA COLLEGE-CORNING CC CAMPUS,20,20,0,23,23,0,0,0,1,0,21,23,0,0,44,28.67
2018,57,STEUBEN,2,INDEPENDENT,1,PRIVATE,1,4-Year/Grad,435020,800000066371,KEUKA COLLEGE-CORNING CC CAMPUS,10,10,0,20,20,0,0,0,0,0,10,20,0,0,30,16.67
2019,57,STEUBEN,2,INDEPENDENT,1,PRIVATE,1,4-Year/Grad,435020,800000066371,KEUKA COLLEGE-CORNING CC CAMPUS,11,11,0,12,12,0,0,0,0,0,11,12,0,0,23,15
2010,31,NEW YORK,2,INDEPENDENT,1,PRIVATE,1,4-Year/Grad,435500,800000057576,THE KING'S COLLEGE,379,378,1,5,3,2,0,0,0,0,379,5,155,0,384,380.67
2011,31,NEW YORK,2,INDEPENDENT,1,PRIVATE,1,4-Year/Grad,435500,800000057576,THE KING'S COLLEGE,453,453,0,12,8,4,0,0,0,0,453,12,162,0,465,457
2012,31,NEW YORK,2,INDEPENDENT,1,PRIVATE,1,4-Year/Grad,435500,800000057576,THE KING'S COLLEGE,564,563,1,18,10,8,0,0,0,0,564,18,202,1,582,570
2013,31,NEW YORK,2,INDEPENDENT,1,PRIVATE,1,4-Year/Grad,435500,800000057576,THE KING'S COLLEGE,492,489,3,24,16,8,0,0,0,0,492,24,125,2,516,500
2014,31,NEW YORK,2,INDEPENDENT,1,PRIVATE,1,4-Year/Grad,435500,800000057576,THE KING'S COLLEGE,473,473,0,13,8,5,0,0,0,0,473,13,143,1,486,477.33
2015,31,NEW YORK,2,INDEPENDENT,1,PRIVATE,1,4-Year/Grad,435500,800000057576,THE KING'S COLLEGE,489,481,8,24,9,15,0,0,0,0,489,24,149,1,513,497
2016,31,NEW YORK,2,INDEPENDENT,1,PRIVATE,1,4-Year/Grad,435500,800000057576,THE KING'S COLLEGE,520,511,9,13,9,4,0,0,0,0,520,13,161,0,533,524.33
2017,31,NEW YORK,2,INDEPENDENT,1,PRIVATE,1,4-Year/Grad,435500,800000057576,THE KING'S COLLEGE,542,526,16,13,7,6,0,0,0,0,542,13,149,0,555,546.33
2018,31,NEW YORK,2,INDEPENDENT,1,PRIVATE,1,4-Year/Grad,435500,800000057576,THE KING'S COLLEGE,535,518,17,19,11,8,0,0,0,0,535,19,143,2,554,541.33
2019,31,NEW YORK,2,INDEPENDENT,1,PRIVATE,1,4-Year/Grad,435500,800000057576,THE KING'S COLLEGE,523,507,16,21,13,8,0,0,0,0,523,21,123,2,544,530
2010,42,ONONDAGA,2,INDEPENDENT,1,PRIVATE,1,4-Year/Grad,437500,800000034173,LE MOYNE COLLEGE,2361,2358,3,425,211,214,0,0,136,580,2497,1005,617,106,3502,2870.67
2011,42,ONONDAGA,2,INDEPENDENT,1,PRIVATE,1,4-Year/Grad,437500,800000034173,LE MOYNE COLLEGE,2414,2409,5,457,231,226,0,0,168,494,2582,951,641,100,3533,2931.93
2012,42,ONONDAGA,2,INDEPENDENT,1,PRIVATE,1,4-Year/Grad,437500,800000034173,LE MOYNE COLLEGE,2338,2334,4,411,215,196,0,0,156,434,2494,845,525,101,3339,2804.6
2013,42,ONONDAGA,2,INDEPENDENT,1,PRIVATE,1,4-Year/Grad,437500,800000034173,LE MOYNE COLLEGE,2401,2394,7,384,225,159,0,0,137,397,2538,781,629,103,3319,2824.8
2014,42,ONONDAGA,2,INDEPENDENT,1,PRIVATE,1,4-Year/Grad,437500,800000034173,LE MOYNE COLLEGE,2500,2489,11,349,239,110,0,0,148,384,2648,733,689,96,3381,2917.93
2015,42,ONONDAGA,2,INDEPENDENT,1,PRIVATE,1,4-Year/Grad,437500,800000034173,LE MOYNE COLLEGE,2495,2487,8,382,282,100,0,0,267,334,2762,716,642,100,3478,3022.93
2016,42,ONONDAGA,2,INDEPENDENT,1,PRIVATE,1,4-Year/Grad,437500,800000034173,LE MOYNE COLLEGE,2534,2531,3,363,262,101,0,0,346,306,2880,669,633,101,3549,3123.4
2017,42,ONONDAGA,2,INDEPENDENT,1,PRIVATE,1,4-Year/Grad,437500,800000034173,LE MOYNE COLLEGE,2410,2403,7,378,274,104,0,0,328,315,2738,693,551,105,3431,2990
2018,42,ONONDAGA,2,INDEPENDENT,1,PRIVATE,1,4-Year/Grad,437500,800000034173,LE MOYNE COLLEGE,2364,2353,11,529,394,135,0,0,321,288,2685,817,667,136,3502,2976.53
2019,42,ONONDAGA,2,INDEPENDENT,1,PRIVATE,1,4-Year/Grad,437500,800000034173,LE MOYNE COLLEGE,2400,2392,8,488,373,115,0,0,292,269,2692,757,662,115,3449,2962.27
2010,33,KINGS,2,INDEPENDENT,1,PRIVATE,1,4-Year/Grad,438000,800000055781,LONG ISLAND COLLEGE HOSPITAL SCHOOL OF NURSING,61,61,0,181,181,0,0,0,0,0,61,181,7,0,242,121.33
2010,33,KINGS,2,INDEPENDENT,1,PRIVATE,1,4-Year/Grad,438510,800000043580,LONG ISLAND UNIVERSITY-BROOKLYN CAMPUS,3467,3046,421,825,748,77,1202,26,1540,1537,6209,2388,912,23,8597,7109.2
2011,33,KINGS,2,INDEPENDENT,1,PRIVATE,1,4-Year/Grad,438510,800000043580,LONG ISLAND UNIVERSITY-BROOKLYN CAMPUS,3587,3579,8,743,676,67,1221,24,1588,1470,6396,2237,1039,7,8633,7241.27
2012,33,KINGS,2,INDEPENDENT,1,PRIVATE,1,4-Year/Grad,438510,800000043580,LONG ISLAND UNIVERSITY-BROOKLYN CAMPUS,3527,3521,6,791,693,98,1154,15,1686,1394,6367,2200,905,12,8567,7194.27
2013,33,KINGS,2,INDEPENDENT,1,PRIVATE,1,4-Year/Grad,438510,800000043580,LONG ISLAND UNIVERSITY-BROOKLYN CAMPUS,3605,3602,3,799,701,98,986,14,1670,1409,6261,2222,864,13,8483,7096.53
2014,33,KINGS,2,INDEPENDENT,1,PRIVATE,1,4-Year/Grad,438510,800000043580,LONG ISLAND UNIVERSITY-BROOKLYN CAMPUS,3262,3259,3,752,634,118,1234,12,1631,1463,6127,2227,829,13,8354,6967.67
2015,33,KINGS,2,INDEPENDENT,1,PRIVATE,1,4-Year/Grad,438510,800000043580,LONG ISLAND UNIVERSITY-BROOKLYN CAMPUS,3170,3165,5,597,511,86,1229,28,1690,1456,6089,2081,808,26,8170,6881.6
2016,33,KINGS,2,INDEPENDENT,1,PRIVATE,1,4-Year/Grad,438510,800000043580,LONG ISLAND UNIVERSITY-BROOKLYN CAMPUS,2913,2909,4,508,380,128,1214,25,1598,1352,5725,1885,698,21,7610,6445.13
2017,33,KINGS,2,INDEPENDENT,1,PRIVATE,1,4-Year/Grad,438510,800000043580,LONG ISLAND UNIVERSITY-BROOKLYN CAMPUS,2524,2521,3,558,364,194,1336,40,1221,1305,5081,1903,665,9,6984,5805
2018,33,KINGS,2,INDEPENDENT,1,PRIVATE,1,4-Year/Grad,438510,800000043580,LONG ISLAND UNIVERSITY-BROOKLYN CAMPUS,3047,3007,40,637,309,328,433,47,592,1734,4072,2418,375,4,6490,4996.73
2019,33,KINGS,2,INDEPENDENT,1,PRIVATE,1,4-Year/Grad,438510,800000043580,LONG ISLAND UNIVERSITY-BROOKLYN CAMPUS,2862,2860,2,478,304,174,460,15,1041,1041,4363,1534,505,5,5897,4944.73
2010,66,WESTCHESTER,2,INDEPENDENT,1,PRIVATE,1,4-Year/Grad,438511,800000035543,LONG ISLAND UNIVERSITY-WESTCHESTER CAMPUS,0,0,0,0,0,0,0,0,103,163,103,163,0,0,266,168.2
2011,66,WESTCHESTER,2,INDEPENDENT,1,PRIVATE,1,4-Year/Grad,438511,800000035543,LONG ISLAND UNIVERSITY-WESTCHESTER CAMPUS,0,0,0,0,0,0,0,0,83,142,83,142,0,0,225,139.8
2012,66,WESTCHESTER,2,INDEPENDENT,1,PRIVATE,1,4-Year/Grad,438511,800000035543,LONG ISLAND UNIVERSITY-WESTCHESTER CAMPUS,0,0,0,0,0,0,0,0,75,137,75,137,0,0,212,129.8
2013,66,WESTCHESTER,2,INDEPENDENT,1,PRIVATE,1,4-Year/Grad,438511,800000035543,LONG ISLAND UNIVERSITY-WESTCHESTER CAMPUS,0,0,0,0,0,0,0,0,63,142,63,142,0,0,205,119.8
2014,66,WESTCHESTER,2,INDEPENDENT,1,PRIVATE,1,4-Year/Grad,438511,800000035543,LONG ISLAND UNIVERSITY-WESTCHESTER CAMPUS,0,0,0,0,0,0,0,0,53,105,53,105,0,0,158,95
2015,66,WESTCHESTER,2,INDEPENDENT,1,PRIVATE,1,4-Year/Grad,438511,800000035543,LONG ISLAND UNIVERSITY-WESTCHESTER CAMPUS,0,0,0,0,0,0,0,0,50,130,50,130,0,0,180,102
2016,66,WESTCHESTER,2,INDEPENDENT,1,PRIVATE,1,4-Year/Grad,438511,800000035543,LONG ISLAND UNIVERSITY-WESTCHESTER CAMPUS,0,0,0,0,0,0,0,0,131,290,131,290,0,0,421,247
2017,66,WESTCHESTER,2,INDEPENDENT,1,PRIVATE,1,4-Year/Grad,438511,800000035543,LONG ISLAND UNIVERSITY-WESTCHESTER CAMPUS,0,0,0,0,0,0,0,0,68,257,68,257,0,0,325,170.8
2018,66,WESTCHESTER,2,INDEPENDENT,1,PRIVATE,1,4-Year/Grad,438511,800000035543,LONG ISLAND UNIVERSITY-WESTCHESTER CAMPUS,0,0,0,0,0,0,0,0,38,286,38,286,0,0,324,152.4
2019,66,WESTCHESTER,2,INDEPENDENT,1,PRIVATE,1,4-Year/Grad,438511,800000035543,LONG ISLAND UNIVERSITY-WESTCHESTER CAMPUS,0,0,0,0,0,0,0,0,87,240,87,240,0,0,327,183
2010,28,NASSAU,2,INDEPENDENT,1,PRIVATE,1,4-Year/Grad,438520,800000048819,LONG ISLAND UNIVERSITY-CW POST CAMPUS,4053,3684,369,3904,459,3445,0,0,1378,1521,5431,5425,866,28,10856,7340.73
2011,28,NASSAU,2,INDEPENDENT,1,PRIVATE,1,4-Year/Grad,438520,800000048819,LONG ISLAND UNIVERSITY-CW POST CAMPUS,4007,3964,43,4460,505,3955,0,0,1220,1448,5227,5908,909,34,11135,7292.87
2012,28,NASSAU,2,INDEPENDENT,1,PRIVATE,1,4-Year/Grad,438520,800000048819,LONG ISLAND UNIVERSITY-CW POST CAMPUS,3978,3935,43,4337,481,3856,0,0,1211,1380,5189,5717,959,21,10906,7186.67
2013,28,NASSAU,2,INDEPENDENT,1,PRIVATE,1,4-Year/Grad,438520,800000048819,LONG ISLAND UNIVERSITY-CW POST CAMPUS,3661,3620,41,4322,447,3875,0,0,1138,1384,4799,5706,631,28,10505,6793.27
2014,28,NASSAU,2,INDEPENDENT,1,PRIVATE,1,4-Year/Grad,438520,800000048819,LONG ISLAND UNIVERSITY-CW POST CAMPUS,3387,3355,32,3730,419,3311,0,0,1075,1213,4462,4943,545,18,9405,6190.53
2015,28,NASSAU,2,INDEPENDENT,1,PRIVATE,1,4-Year/Grad,438520,800000048819,LONG ISLAND UNIVERSITY-CW POST CAMPUS,3090,3060,30,3134,383,2751,0,0,1186,1116,4276,4250,511,19,8526,5767.07
2016,28,NASSAU,2,INDEPENDENT,1,PRIVATE,1,4-Year/Grad,438520,800000048819,LONG ISLAND UNIVERSITY-CW POST CAMPUS,2875,2841,34,3398,287,3111,0,0,1125,1172,4000,4570,532,3,8570,5601.47
2017,28,NASSAU,2,INDEPENDENT,1,PRIVATE,1,4-Year/Grad,438520,800000048819,LONG ISLAND UNIVERSITY-CW POST CAMPUS,2823,2779,44,3493,354,3139,0,0,995,1174,3818,4667,689,5,8485,5451.93
2018,28,NASSAU,2,INDEPENDENT,1,PRIVATE,1,4-Year/Grad,438520,800000048819,LONG ISLAND UNIVERSITY-CW POST CAMPUS,2618,2572,46,3588,368,3220,0,0,526,1386,3144,4974,561,3,8118,4894.4
2019,28,NASSAU,2,INDEPENDENT,1,PRIVATE,1,4-Year/Grad,438520,800000048819,LONG ISLAND UNIVERSITY-CW POST CAMPUS,2747,2653,94,4597,324,4273,0,0,882,865,3629,5462,769,1,9091,5507.33
2010,50,ROCKLAND,2,INDEPENDENT,1,PRIVATE,1,4-Year/Grad,438521,800000039212,LIU-HUDSON GRADUATE CENTER AT ROCKLAND,0,0,0,0,0,0,0,0,153,305,153,305,0,0,458,275
2011,50,ROCKLAND,2,INDEPENDENT,1,PRIVATE,1,4-Year/Grad,438521,800000039212,LIU-HUDSON GRADUATE CENTER AT ROCKLAND,0,0,0,0,0,0,0,0,100,220,100,220,0,0,320,188
2012,50,ROCKLAND,2,INDEPENDENT,1,PRIVATE,1,4-Year/Grad,438521,800000039212,LIU-HUDSON GRADUATE CENTER AT ROCKLAND,0,0,0,0,0,0,0,0,102,166,102,166,0,0,268,168.4
2013,50,ROCKLAND,2,INDEPENDENT,1,PRIVATE,1,4-Year/Grad,438521,800000039212,LIU-HUDSON GRADUATE CENTER AT ROCKLAND,0,0,0,0,0,0,0,0,94,165,94,165,0,0,259,160
2014,50,ROCKLAND,2,INDEPENDENT,1,PRIVATE,1,4-Year/Grad,438521,800000039212,LIU-HUDSON GRADUATE CENTER AT ROCKLAND,0,0,0,0,0,0,0,0,74,165,74,165,0,0,239,140
2015,50,ROCKLAND,2,INDEPENDENT,1,PRIVATE,1,4-Year/Grad,438521,800000039212,LIU-HUDSON GRADUATE CENTER AT ROCKLAND,0,0,0,0,0,0,0,0,90,177,90,177,0,0,267,160.8
2010,58,SUFFOLK,2,INDEPENDENT,1,PRIVATE,1,4-Year/Grad,438523,800000037015,LONG ISLAND UNIVERSITY-BRENTWOOD CAMPUS,18,18,0,9,9,0,0,0,191,221,209,230,0,0,439,300.4
2011,58,SUFFOLK,2,INDEPENDENT,1,PRIVATE,1,4-Year/Grad,438523,800000037015,LONG ISLAND UNIVERSITY-BRENTWOOD CAMPUS,18,18,0,8,8,0,0,0,161,204,179,212,0,0,391,263.27
2012,58,SUFFOLK,2,INDEPENDENT,1,PRIVATE,1,4-Year/Grad,438523,800000037015,LONG ISLAND UNIVERSITY-BRENTWOOD CAMPUS,18,18,0,12,12,0,0,0,135,175,153,187,0,0,340,227
2013,58,SUFFOLK,2,INDEPENDENT,1,PRIVATE,1,4-Year/Grad,438523,800000037015,LONG ISLAND UNIVERSITY-BRENTWOOD CAMPUS,15,15,0,8,8,0,0,0,115,132,130,140,0,0,270,185.47
2014,58,SUFFOLK,2,INDEPENDENT,1,PRIVATE,1,4-Year/Grad,438523,800000037015,LONG ISLAND UNIVERSITY-BRENTWOOD CAMPUS,9,9,0,6,6,0,0,0,108,93,117,99,0,0,216,156.2
2015,58,SUFFOLK,2,INDEPENDENT,1,PRIVATE,1,4-Year/Grad,438523,800000037015,LONG ISLAND UNIVERSITY-BRENTWOOD CAMPUS,2,2,0,8,8,0,0,0,89,93,91,101,0,0,192,130.87
2016,58,SUFFOLK,2,INDEPENDENT,1,PRIVATE,1,4-Year/Grad,438523,800000037015,LONG ISLAND UNIVERSITY-BRENTWOOD CAMPUS,2,2,0,3,2,1,0,0,98,57,100,60,0,0,160,123.8
2017,58,SUFFOLK,2,INDEPENDENT,1,PRIVATE,1,4-Year/Grad,438523,800000037015,LONG ISLAND UNIVERSITY-BRENTWOOD CAMPUS,0,0,0,1,1,0,0,0,110,54,110,55,0,0,165,131.93
2018,58,SUFFOLK,2,INDEPENDENT,1,PRIVATE,1,4-Year/Grad,438523,800000037015,LONG ISLAND UNIVERSITY-BRENTWOOD CAMPUS,6,6,0,0,0,0,0,0,64,74,70,74,0,0,144,99.6
2019,58,SUFFOLK,2,INDEPENDENT,1,PRIVATE,1,4-Year/Grad,438523,800000037015,LONG ISLAND UNIVERSITY-BRENTWOOD CAMPUS,4,4,0,0,0,0,0,0,84,42,88,42,0,0,130,104.8
2010,31,NEW YORK,2,INDEPENDENT,1,PRIVATE,1,4-Year/Grad,438540,800000057565,LONG ISLAND UNIVERSITY - NEW YORK UNIVERSITY CAMPUS,0,0,0,0,0,0,0,0,63,133,63,133,0,0,196,116.2
2011,31,NEW YORK,2,INDEPENDENT,1,PRIVATE,1,4-Year/Grad,438540,800000057565,LONG ISLAND UNIVERSITY - NEW YORK UNIVERSITY CAMPUS,0,0,0,0,0,0,0,0,46,129,46,129,0,0,175,97.6
2012,31,NEW YORK,2,INDEPENDENT,1,PRIVATE,1,4-Year/Grad,438540,800000057565,LONG ISLAND UNIVERSITY - NEW YORK UNIVERSITY CAMPUS,0,0,0,0,0,0,0,0,30,76,30,76,0,0,106,60.4
2013,31,NEW YORK,2,INDEPENDENT,1,PRIVATE,1,4-Year/Grad,438540,800000057565,LONG ISLAND UNIVERSITY - NEW YORK UNIVERSITY CAMPUS,0,0,0,0,0,0,0,0,25,69,25,69,0,0,94,52.6
2014,31,NEW YORK,2,INDEPENDENT,1,PRIVATE,1,4-Year/Grad,438540,800000057565,LONG ISLAND UNIVERSITY - NEW YORK UNIVERSITY CAMPUS,0,0,0,0,0,0,0,0,21,61,21,61,0,0,82,45.4
2015,31,NEW YORK,2,INDEPENDENT,1,PRIVATE,1,4-Year/Grad,438540,800000057565,LONG ISLAND UNIVERSITY - NEW YORK UNIVERSITY CAMPUS,0,0,0,0,0,0,0,0,23,74,23,74,0,0,97,52.6
2016,31,NEW YORK,2,INDEPENDENT,1,PRIVATE,1,4-Year/Grad,438540,800000057565,LONG ISLAND UNIVERSITY - NEW YORK UNIVERSITY CAMPUS,0,0,0,0,0,0,0,0,23,30,23,30,0,0,53,35
2017,31,NEW YORK,2,INDEPENDENT,1,PRIVATE,1,4-Year/Grad,438540,800000057565,LONG ISLAND UNIVERSITY - NEW YORK UNIVERSITY CAMPUS,0,0,0,0,0,0,0,0,1,13,1,13,0,0,14,6.2
2018,31,NEW YORK,2,INDEPENDENT,1,PRIVATE,1,4-Year/Grad,438540,800000057565,LONG ISLAND UNIVERSITY - NEW YORK UNIVERSITY CAMPUS,0,0,0,0,0,0,0,0,0,21,0,21,0,0,21,8.4
2019,31,NEW YORK,2,INDEPENDENT,1,PRIVATE,1,4-Year/Grad,438540,800000057565,LONG ISLAND UNIVERSITY - NEW YORK UNIVERSITY CAMPUS,0,0,0,0,0,0,0,0,4,14,4,14,0,0,18,9.6
2010,58,SUFFOLK,2,INDEPENDENT,1,PRIVATE,1,4-Year/Grad,438550,800000063491,LONG ISLAND UNIVERSITY - RIVERHEAD,29,29,0,5,5,0,0,0,39,193,68,198,0,0,266,146.87
2011,58,SUFFOLK,2,INDEPENDENT,1,PRIVATE,1,4-Year/Grad,438550,800000063491,LONG ISLAND UNIVERSITY - RIVERHEAD,30,30,0,15,15,0,0,0,18,172,48,187,0,0,235,121.8
2012,58,SUFFOLK,2,INDEPENDENT,1,PRIVATE,1,4-Year/Grad,438550,800000063491,LONG ISLAND UNIVERSITY - RIVERHEAD,40,40,0,11,11,0,0,0,14,157,54,168,0,0,222,120.47
2013,58,SUFFOLK,2,INDEPENDENT,1,PRIVATE,1,4-Year/Grad,438550,800000063491,LONG ISLAND UNIVERSITY - RIVERHEAD,43,43,0,13,13,0,0,0,14,145,57,158,0,0,215,119.33
2014,58,SUFFOLK,2,INDEPENDENT,1,PRIVATE,1,4-Year/Grad,438550,800000063491,LONG ISLAND UNIVERSITY - RIVERHEAD,29,29,0,10,9,1,0,0,19,110,48,120,0,0,168,95.33
2015,58,SUFFOLK,2,INDEPENDENT,1,PRIVATE,1,4-Year/Grad,438550,800000063491,LONG ISLAND UNIVERSITY - RIVERHEAD,32,32,0,7,7,0,0,0,22,90,54,97,0,0,151,92.33
2016,58,SUFFOLK,2,INDEPENDENT,1,PRIVATE,1,4-Year/Grad,438550,800000063491,LONG ISLAND UNIVERSITY - RIVERHEAD,33,33,0,5,5,0,0,0,22,70,55,75,0,0,130,84.67
2017,58,SUFFOLK,2,INDEPENDENT,1,PRIVATE,1,4-Year/Grad,438550,800000063491,LONG ISLAND UNIVERSITY - RIVERHEAD,19,19,0,9,9,0,0,0,17,61,36,70,0,0,106,63.4
2018,58,SUFFOLK,2,INDEPENDENT,1,PRIVATE,1,4-Year/Grad,438550,800000063491,LONG ISLAND UNIVERSITY - RIVERHEAD,17,17,0,5,5,0,0,0,9,69,26,74,0,0,100,55.27
2019,58,SUFFOLK,2,INDEPENDENT,1,PRIVATE,1,4-Year/Grad,438550,800000063491,LONG ISLAND UNIVERSITY - RIVERHEAD,17,17,0,2,2,0,0,0,16,48,33,50,0,0,83,52.87
2010,32,BRONX,2,INDEPENDENT,1,PRIVATE,1,4-Year/Grad,439000,800000046083,MANHATTAN COLLEGE,2913,2913,0,89,89,0,0,0,156,254,3069,343,658,2,3412,3200.27
2011,32,BRONX,2,INDEPENDENT,1,PRIVATE,1,4-Year/Grad,439000,800000046083,MANHATTAN COLLEGE,3006,3006,0,231,231,0,0,0,182,238,3188,469,802,0,3657,3360.2
2012,32,BRONX,2,INDEPENDENT,1,PRIVATE,1,4-Year/Grad,439000,800000046083,MANHATTAN COLLEGE,3141,3141,0,210,210,0,0,0,190,259,3331,469,842,0,3800,3504.6
2013,32,BRONX,2,INDEPENDENT,1,PRIVATE,1,4-Year/Grad,439000,800000046083,MANHATTAN COLLEGE,3195,3195,0,208,208,0,0,0,197,283,3392,491,755,2,3883,3574.53
2014,32,BRONX,2,INDEPENDENT,1,PRIVATE,1,4-Year/Grad,439000,800000046083,MANHATTAN COLLEGE,3276,3276,0,195,195,0,0,0,230,269,3506,464,747,0,3970,3678.6
2015,32,BRONX,2,INDEPENDENT,1,PRIVATE,1,4-Year/Grad,439000,800000046083,MANHATTAN COLLEGE,3384,3384,0,192,192,0,0,0,217,278,3601,470,900,0,4071,3776.2
2016,32,BRONX,2,INDEPENDENT,1,PRIVATE,1,4-Year/Grad,439000,800000046083,MANHATTAN COLLEGE,3444,3444,0,193,193,0,0,0,483,94,3927,287,814,2,4214,4028.93
2017,32,BRONX,2,INDEPENDENT,1,PRIVATE,1,4-Year/Grad,439000,800000046083,MANHATTAN COLLEGE,3479,3479,0,184,184,0,0,0,472,106,3951,290,764,1,4241,4054.73
2018,32,BRONX,2,INDEPENDENT,1,PRIVATE,1,4-Year/Grad,439000,800000046083,MANHATTAN COLLEGE,3455,3455,0,199,199,0,0,0,471,107,3926,306,813,2,4232,4035.13
2019,32,BRONX,2,INDEPENDENT,1,PRIVATE,1,4-Year/Grad,439000,800000046083,MANHATTAN COLLEGE,3455,3455,0,199,199,0,0,0,471,107,3926,306,813,2,4232,4035.13
2010,31,NEW YORK,2,INDEPENDENT,1,PRIVATE,1,4-Year/Grad,439500,800000047064,MANHATTAN SCHOOL OF MUSIC,401,397,4,6,5,1,0,0,519,8,920,14,98,0,934,925.2
2011,31,NEW YORK,2,INDEPENDENT,1,PRIVATE,1,4-Year/Grad,439500,800000047064,MANHATTAN SCHOOL OF MUSIC,405,404,1,2,1,1,0,0,551,3,956,5,98,0,961,957.87
2012,31,NEW YORK,2,INDEPENDENT,1,PRIVATE,1,4-Year/Grad,439500,800000047064,MANHATTAN SCHOOL OF MUSIC,386,385,1,6,5,1,0,0,548,1,934,7,86,0,941,936.4
2013,31,NEW YORK,2,INDEPENDENT,1,PRIVATE,1,4-Year/Grad,439500,800000047064,MANHATTAN SCHOOL OF MUSIC,377,376,1,1,1,0,0,0,509,2,886,3,81,0,889,887.13
2014,31,NEW YORK,2,INDEPENDENT,1,PRIVATE,1,4-Year/Grad,439500,800000047064,MANHATTAN SCHOOL OF MUSIC,386,385,1,4,4,0,0,0,569,2,955,6,113,0,961,957.13
2015,31,NEW YORK,2,INDEPENDENT,1,PRIVATE,1,4-Year/Grad,439500,800000047064,MANHATTAN SCHOOL OF MUSIC,413,409,4,1,1,0,0,0,594,0,1007,1,112,0,1008,1007.33
2016,31,NEW YORK,2,INDEPENDENT,1,PRIVATE,1,4-Year/Grad,439500,800000047064,MANHATTAN SCHOOL OF MUSIC,473,473,0,2,2,0,44,0,544,2,1061,4,149,0,1065,1062.47
2018,31,NEW YORK,2,INDEPENDENT,1,PRIVATE,1,4-Year/Grad,439500,800000047064,MANHATTAN SCHOOL OF MUSIC,508,508,0,4,4,0,0,0,495,1,1003,5,145,0,1008,1004.73
2019,31,NEW YORK,2,INDEPENDENT,1,PRIVATE,1,4-Year/Grad,439500,800000047064,MANHATTAN SCHOOL OF MUSIC,521,521,0,3,3,0,0,0,496,3,1017,6,116,0,1023,1019.2
2010,66,WESTCHESTER,2,INDEPENDENT,1,PRIVATE,1,4-Year/Grad,440000,800000035406,MANHATTANVILLE COLLEGE,1626,1626,0,97,31,66,0,0,370,602,1996,699,430,0,2695,2269.13
2011,66,WESTCHESTER,2,INDEPENDENT,1,PRIVATE,1,4-Year/Grad,440000,800000035406,MANHATTANVILLE COLLEGE,1637,1636,1,94,47,47,0,0,391,733,2028,827,534,0,2855,2352.53
2012,66,WESTCHESTER,2,INDEPENDENT,1,PRIVATE,1,4-Year/Grad,440000,800000035406,MANHATTANVILLE COLLEGE,1658,1657,1,105,51,54,0,0,325,873,1983,978,534,1,2961,2367.2
2013,66,WESTCHESTER,2,INDEPENDENT,1,PRIVATE,1,4-Year/Grad,440000,800000035406,MANHATTANVILLE COLLEGE,1606,1606,0,82,31,51,0,0,253,790,1859,872,477,0,2731,2202.33
2014,66,WESTCHESTER,2,INDEPENDENT,1,PRIVATE,1,4-Year/Grad,440000,800000035406,MANHATTANVILLE COLLEGE,1708,1707,1,90,47,43,0,0,220,847,1928,937,459,1,2865,2296.8
2015,66,WESTCHESTER,2,INDEPENDENT,1,PRIVATE,1,4-Year/Grad,440000,800000035406,MANHATTANVILLE COLLEGE,1695,1695,0,108,48,60,0,0,237,885,1932,993,450,2,2925,2322
2016,66,WESTCHESTER,2,INDEPENDENT,1,PRIVATE,1,4-Year/Grad,440000,800000035406,MANHATTANVILLE COLLEGE,1701,1698,3,93,37,56,0,0,268,772,1969,865,482,1,2834,2308.8
2017,66,WESTCHESTER,2,INDEPENDENT,1,PRIVATE,1,4-Year/Grad,440000,800000035406,MANHATTANVILLE COLLEGE,1633,1632,1,87,37,50,0,0,339,618,1972,705,416,1,2677,2248.2
2018,66,WESTCHESTER,2,INDEPENDENT,1,PRIVATE,1,4-Year/Grad,440000,800000035406,MANHATTANVILLE COLLEGE,1513,1511,2,75,33,42,0,0,325,579,1838,654,392,2,2492,2094.6
2019,66,WESTCHESTER,2,INDEPENDENT,1,PRIVATE,1,4-Year/Grad,440000,800000035406,MANHATTANVILLE COLLEGE,1474,1470,4,67,34,33,0,0,341,653,1815,720,399,2,2535,2098.53
2010,01,ALBANY,2,INDEPENDENT,1,PRIVATE,1,4-Year/Grad,441000,800000055536,MARIA COLLEGE OF ALBANY,239,239,0,628,594,34,0,0,0,0,239,628,34,18,867,448.33
2011,01,ALBANY,2,INDEPENDENT,1,PRIVATE,1,4-Year/Grad,441000,800000055536,MARIA COLLEGE OF ALBANY,242,240,2,664,646,18,0,0,0,0,242,664,34,26,906,463.33
2012,01,ALBANY,2,INDEPENDENT,1,PRIVATE,1,4-Year/Grad,441000,800000055536,MARIA COLLEGE OF ALBANY,198,198,0,687,668,19,0,0,0,0,198,687,32,19,885,427
2013,01,ALBANY,2,INDEPENDENT,1,PRIVATE,1,4-Year/Grad,441000,800000055536,MARIA COLLEGE OF ALBANY,192,191,1,643,618,25,0,0,0,0,192,643,26,20,835,406.33
2014,01,ALBANY,2,INDEPENDENT,1,PRIVATE,1,4-Year/Grad,441000,800000055536,MARIA COLLEGE OF ALBANY,243,239,4,623,607,16,0,0,0,0,243,623,36,11,866,450.67
2015,01,ALBANY,2,INDEPENDENT,1,PRIVATE,1,4-Year/Grad,441000,800000055536,MARIA COLLEGE OF ALBANY,297,297,0,511,504,7,0,0,0,0,297,511,54,9,808,467.33
2016,01,ALBANY,2,INDEPENDENT,1,PRIVATE,1,4-Year/Grad,441000,800000055536,MARIA COLLEGE OF ALBANY,245,245,0,534,526,8,0,0,0,0,245,534,52,24,779,423
2017,01,ALBANY,2,INDEPENDENT,1,PRIVATE,1,4-Year/Grad,441000,800000055536,MARIA COLLEGE OF ALBANY,246,246,0,613,587,26,0,0,0,0,246,613,18,32,859,450.33
2018,01,ALBANY,2,INDEPENDENT,1,PRIVATE,1,4-Year/Grad,441000,800000055536,MARIA COLLEGE OF ALBANY,243,243,0,669,632,37,0,0,0,0,243,669,31,25,912,466
2010,13,DUTCHESS,2,INDEPENDENT,1,PRIVATE,1,4-Year/Grad,442000,800000034131,MARIST COLLEGE,4532,4512,20,657,299,358,0,0,248,703,4780,1360,1095,0,6140,5280.2
2011,13,DUTCHESS,2,INDEPENDENT,1,PRIVATE,1,4-Year/Grad,442000,800000034131,MARIST COLLEGE,4673,4667,6,769,352,417,0,0,246,615,4919,1384,1174,0,6303,5421.33
2012,13,DUTCHESS,2,INDEPENDENT,1,PRIVATE,1,4-Year/Grad,442000,800000034131,MARIST COLLEGE,4768,4760,8,792,377,415,0,0,202,615,4970,1407,1098,0,6377,5480
2013,13,DUTCHESS,2,INDEPENDENT,1,PRIVATE,1,4-Year/Grad,442000,800000034131,MARIST COLLEGE,4924,4918,6,642,377,265,0,0,197,602,5121,1244,1149,0,6365,5575.8
2014,13,DUTCHESS,2,INDEPENDENT,1,PRIVATE,1,4-Year/Grad,442000,800000034131,MARIST COLLEGE,4876,4872,4,640,368,272,0,0,245,595,5121,1235,1127,0,6356,5572.33
2015,13,DUTCHESS,2,INDEPENDENT,1,PRIVATE,1,4-Year/Grad,442000,800000034131,MARIST COLLEGE,4874,4873,1,702,333,369,0,0,328,570,5202,1272,1209,0,6474,5664
2016,13,DUTCHESS,2,INDEPENDENT,1,PRIVATE,1,4-Year/Grad,442000,800000034131,MARIST COLLEGE,4966,4964,2,650,344,306,0,0,293,660,5259,1310,1225,0,6569,5739.67
2017,13,DUTCHESS,2,INDEPENDENT,1,PRIVATE,1,4-Year/Grad,442000,800000034131,MARIST COLLEGE,5085,5084,1,614,320,294,0,0,308,650,5393,1264,1285,0,6657,5857.67
2018,13,DUTCHESS,2,INDEPENDENT,1,PRIVATE,1,4-Year/Grad,442000,800000034131,MARIST COLLEGE,5139,5135,4,531,270,261,14,0,287,653,5440,1184,1299,0,6624,5878.2
2019,13,DUTCHESS,2,INDEPENDENT,1,PRIVATE,1,4-Year/Grad,442000,800000034131,MARIST COLLEGE,5199,5198,1,625,262,363,44,0,268,602,5511,1227,1358,0,6738,5960.13
2010,31,NEW YORK,2,INDEPENDENT,1,PRIVATE,1,4-Year/Grad,443500,800000047856,MARYMOUNT MANHATTAN COLLEGE,1782,1762,20,313,277,36,0,0,0,0,1782,313,473,32,2095,1886.33
2011,31,NEW YORK,2,INDEPENDENT,1,PRIVATE,1,4-Year/Grad,443500,800000047856,MARYMOUNT MANHATTAN COLLEGE,1707,1692,15,246,209,37,0,0,0,0,1707,246,420,19,1953,1789
2012,31,NEW YORK,2,INDEPENDENT,1,PRIVATE,1,4-Year/Grad,443500,800000047856,MARYMOUNT MANHATTAN COLLEGE,1692,1673,19,245,204,41,0,0,0,0,1692,245,461,24,1937,1773.67
2013,31,NEW YORK,2,INDEPENDENT,1,PRIVATE,1,4-Year/Grad,443500,800000047856,MARYMOUNT MANHATTAN COLLEGE,1593,1583,10,240,200,40,0,0,0,0,1593,240,397,19,1833,1673
2014,31,NEW YORK,2,INDEPENDENT,1,PRIVATE,1,4-Year/Grad,443500,800000047856,MARYMOUNT MANHATTAN COLLEGE,1640,1626,14,218,189,29,0,0,0,0,1640,218,495,16,1858,1712.67
2015,31,NEW YORK,2,INDEPENDENT,1,PRIVATE,1,4-Year/Grad,443500,800000047856,MARYMOUNT MANHATTAN COLLEGE,1711,1700,11,217,175,42,0,0,0,0,1711,217,514,10,1928,1783.33
2016,31,NEW YORK,2,INDEPENDENT,1,PRIVATE,1,4-Year/Grad,443500,800000047856,MARYMOUNT MANHATTAN COLLEGE,1841,1824,17,228,203,25,0,0,0,0,1841,228,535,17,2069,1917
2017,31,NEW YORK,2,INDEPENDENT,1,PRIVATE,1,4-Year/Grad,443500,800000047856,MARYMOUNT MANHATTAN COLLEGE,1915,1899,16,235,210,25,0,0,0,0,1915,235,516,29,2150,1993.33
2018,31,NEW YORK,2,INDEPENDENT,1,PRIVATE,1,4-Year/Grad,443500,800000047856,MARYMOUNT MANHATTAN COLLEGE,1861,1841,20,202,191,11,0,0,0,0,1861,202,471,12,2063,1928.33
2019,31,NEW YORK,2,INDEPENDENT,1,PRIVATE,1,4-Year/Grad,443500,800000047856,MARYMOUNT MANHATTAN COLLEGE,1660,1649,11,232,194,38,0,0,0,0,1660,232,421,17,1892,1737.33
2010,14,ERIE,2,INDEPENDENT,1,PRIVATE,1,4-Year/Grad,444500,800000052572,MEDAILLE COLLEGE,1694,1694,0,151,131,20,0,0,717,174,2411,325,374,41,2736,2530.93
2011,14,ERIE,2,INDEPENDENT,1,PRIVATE,1,4-Year/Grad,444500,800000052572,MEDAILLE COLLEGE,1660,1660,0,137,133,4,0,0,823,59,2483,196,373,2,2679,2552.27
2012,14,ERIE,2,INDEPENDENT,1,PRIVATE,1,4-Year/Grad,444500,800000052572,MEDAILLE COLLEGE,1650,1646,4,194,189,5,0,0,692,98,2342,292,395,5,2634,2445.87
2013,14,ERIE,2,INDEPENDENT,1,PRIVATE,1,4-Year/Grad,444500,800000052572,MEDAILLE COLLEGE,1586,1576,10,142,141,1,0,0,590,73,2176,215,436,7,2391,2252.53
2014,14,ERIE,2,INDEPENDENT,1,PRIVATE,1,4-Year/Grad,444500,800000052572,MEDAILLE COLLEGE,1681,1672,9,122,77,45,0,0,534,46,2215,168,433,5,2383,2274.07
2015,14,ERIE,2,INDEPENDENT,1,PRIVATE,1,4-Year/Grad,444500,800000052572,MEDAILLE COLLEGE,1455,1442,13,128,79,49,0,0,489,96,1944,224,373,8,2168,2025.07
2016,14,ERIE,2,INDEPENDENT,1,PRIVATE,1,4-Year/Grad,444500,800000052572,MEDAILLE COLLEGE,1193,1178,15,298,217,81,0,0,109,433,1302,731,311,43,2033,1574.53
2017,14,ERIE,2,INDEPENDENT,1,PRIVATE,1,4-Year/Grad,444500,800000052572,MEDAILLE COLLEGE,1271,1258,13,134,95,39,0,0,402,239,1673,373,345,26,2046,1813.27
2018,14,ERIE,2,INDEPENDENT,1,PRIVATE,1,4-Year/Grad,444500,800000052572,MEDAILLE COLLEGE,1333,1329,4,91,70,21,0,0,510,92,1843,183,532,36,2026,1910.13
2019,14,ERIE,2,INDEPENDENT,1,PRIVATE,1,4-Year/Grad,444500,800000052572,MEDAILLE COLLEGE,1299,1292,7,95,81,14,0,0,473,69,1772,164,506,43,1936,1831.27
2016,26,MONROE,2,INDEPENDENT,1,PRIVATE,1,4-Year/Grad,444520,800000065072,MEDAILLE COLLEGE - ROCHESTER CAMPUS,124,124,0,21,21,0,0,0,1,40,125,61,5,0,186,148
2017,26,MONROE,2,INDEPENDENT,1,PRIVATE,1,4-Year/Grad,444520,800000065072,MEDAILLE COLLEGE - ROCHESTER CAMPUS,101,101,0,27,27,0,0,0,30,10,131,37,3,0,168,144
2018,26,MONROE,2,INDEPENDENT,1,PRIVATE,1,4-Year/Grad,444520,800000065072,MEDAILLE COLLEGE - ROCHESTER CAMPUS,79,79,0,22,22,0,0,0,52,1,131,23,24,12,154,138.73
2019,26,MONROE,2,INDEPENDENT,1,PRIVATE,1,4-Year/Grad,444520,800000065072,MEDAILLE COLLEGE - ROCHESTER CAMPUS,62,62,0,32,32,0,0,0,35,0,97,32,14,16,129,107.67
2010,01,ALBANY,2,INDEPENDENT,1,PRIVATE,0,2-Year,444600,800000055561,MEMORIAL HOSPITAL SCHOOL OF NURSING,13,13,0,96,96,0,0,0,0,0,13,96,1,2,109,45
2011,01,ALBANY,2,INDEPENDENT,1,PRIVATE,0,2-Year,444600,800000055561,MEMORIAL HOSPITAL SCHOOL OF NURSING,11,11,0,104,104,0,0,0,0,0,11,104,1,0,115,45.67
2012,01,ALBANY,2,INDEPENDENT,1,PRIVATE,0,2-Year,444600,800000055561,MEMORIAL HOSPITAL SCHOOL OF NURSING,11,11,0,100,100,0,0,0,0,0,11,100,0,3,111,44.33
2013,01,ALBANY,2,INDEPENDENT,1,PRIVATE,0,2-Year,444600,800000055561,MEMORIAL HOSPITAL SCHOOL OF NURSING,12,12,0,114,114,0,0,0,0,0,12,114,1,0,126,50
2014,01,ALBANY,2,INDEPENDENT,1,PRIVATE,0,2-Year,444600,800000055561,MEMORIAL HOSPITAL SCHOOL OF NURSING,11,11,0,110,110,0,0,0,0,0,11,110,2,0,121,47.67
2015,01,ALBANY,2,INDEPENDENT,1,PRIVATE,0,2-Year,444600,800000055561,MEMORIAL HOSPITAL SCHOOL OF NURSING,3,3,0,130,130,0,0,0,0,0,3,130,2,0,133,46.33
2016,01,ALBANY,2,INDEPENDENT,1,PRIVATE,0,2-Year,444600,800000055561,MEMORIAL HOSPITAL SCHOOL OF NURSING,9,9,0,120,120,0,0,0,0,0,9,120,2,0,129,49
2017,01,ALBANY,2,INDEPENDENT,1,PRIVATE,0,2-Year,444600,800000055561,MEMORIAL HOSPITAL SCHOOL OF NURSING,6,6,0,113,113,0,0,0,0,0,6,113,0,0,119,43.67
2018,01,ALBANY,2,INDEPENDENT,1,PRIVATE,0,2-Year,444600,800000055561,MEMORIAL HOSPITAL SCHOOL OF NURSING,9,9,0,105,105,0,0,0,0,0,9,105,0,0,114,44
2010,66,WESTCHESTER,2,INDEPENDENT,1,PRIVATE,1,4-Year/Grad,445000,800000035544,MERCY COLLEGE,4868,4822,46,2185,1415,770,88,21,1495,2194,6451,4400,1119,726,10851,8065.33
2011,66,WESTCHESTER,2,INDEPENDENT,1,PRIVATE,1,4-Year/Grad,445000,800000035544,MERCY COLLEGE,5451,5434,17,2517,1506,1011,72,26,1373,2100,6896,4643,1173,19,11539,8585.4
2012,66,WESTCHESTER,2,INDEPENDENT,1,PRIVATE,1,4-Year/Grad,445000,800000035544,MERCY COLLEGE,5505,5425,80,2524,1545,979,70,22,1279,2054,6854,4600,807,26,11454,8525.73
2013,66,WESTCHESTER,2,INDEPENDENT,1,PRIVATE,1,4-Year/Grad,445000,800000035544,MERCY COLLEGE,5547,5447,100,2607,1450,1157,67,26,1403,1998,7017,4631,823,11,11648,8695.6
2014,66,WESTCHESTER,2,INDEPENDENT,1,PRIVATE,1,4-Year/Grad,445000,800000035544,MERCY COLLEGE,5289,5110,179,2650,1292,1358,70,29,1387,1847,6746,4526,737,10,11272,8379.73
2015,66,WESTCHESTER,2,INDEPENDENT,1,PRIVATE,1,4-Year/Grad,445000,800000035544,MERCY COLLEGE,5392,5246,146,2624,1164,1460,78,28,1353,1820,6823,4472,925,13,11295,8436.87
2016,66,WESTCHESTER,2,INDEPENDENT,1,PRIVATE,1,4-Year/Grad,445000,800000035544,MERCY COLLEGE,3675,3640,35,1683,867,816,80,31,787,1266,4542,2980,654,33,7522,5621.8
2017,66,WESTCHESTER,2,INDEPENDENT,1,PRIVATE,1,4-Year/Grad,445000,800000035544,MERCY COLLEGE,3607,3576,31,1576,793,783,100,16,688,1122,4395,2714,565,40,7109,5375.53
2018,66,WESTCHESTER,2,INDEPENDENT,1,PRIVATE,1,4-Year/Grad,445000,800000035544,MERCY COLLEGE,3607,3587,20,1394,697,697,103,16,662,1016,4372,2426,576,43,6798,5249.47
2019,66,WESTCHESTER,2,INDEPENDENT,1,PRIVATE,1,4-Year/Grad,445000,800000035544,MERCY COLLEGE,3730,3707,23,1415,676,739,85,34,698,1011,4513,2460,673,28,6973,5402.67
2016,66,WESTCHESTER,2,INDEPENDENT,1,PRIVATE,1,4-Year/Grad,445010,800000034549,MERCY COLLEGE-YORKTOWN HTS CAMPUS,19,19,0,12,12,0,0,0,22,20,41,32,0,0,73,53
2017,66,WESTCHESTER,2,INDEPENDENT,1,PRIVATE,1,4-Year/Grad,445010,800000034549,MERCY COLLEGE-YORKTOWN HTS CAMPUS,15,15,0,5,4,1,0,0,11,9,26,14,1,0,40,31.27
2018,66,WESTCHESTER,2,INDEPENDENT,1,PRIVATE,1,4-Year/Grad,445010,800000034549,MERCY COLLEGE-YORKTOWN HTS CAMPUS,22,22,0,6,5,1,0,0,18,11,40,17,3,0,57,46.4
2019,66,WESTCHESTER,2,INDEPENDENT,1,PRIVATE,1,4-Year/Grad,445010,800000034549,MERCY COLLEGE-YORKTOWN HTS CAMPUS,9,9,0,2,1,1,0,0,7,20,16,22,0,0,38,24.67
2016,32,BRONX,2,INDEPENDENT,1,PRIVATE,1,4-Year/Grad,445020,800000045843,MERCY COLLEGE BRONX CAMPUS,836,836,0,200,188,12,0,0,269,235,1105,435,117,1,1540,1265.67
2017,32,BRONX,2,INDEPENDENT,1,PRIVATE,1,4-Year/Grad,445020,800000045843,MERCY COLLEGE BRONX CAMPUS,826,825,1,181,170,11,0,0,277,189,1103,370,171,3,1473,1238.93
2018,32,BRONX,2,INDEPENDENT,1,PRIVATE,1,4-Year/Grad,445020,800000045843,MERCY COLLEGE BRONX CAMPUS,822,822,0,161,147,14,0,0,254,178,1076,339,189,2,1415,1200.87
2019,32,BRONX,2,INDEPENDENT,1,PRIVATE,1,4-Year/Grad,445020,800000045843,MERCY COLLEGE BRONX CAMPUS,1969,1968,1,316,301,15,0,0,232,335,2201,651,166,1,2852,2440.33
2016,31,NEW YORK,2,INDEPENDENT,1,PRIVATE,1,4-Year/Grad,445060,800000057566,MERCY COLLEGE - MANHATTAN CAMPUS,652,648,4,80,76,4,0,0,180,52,832,132,142,1,964,879.47
2017,31,NEW YORK,2,INDEPENDENT,1,PRIVATE,1,4-Year/Grad,445060,800000057566,MERCY COLLEGE - MANHATTAN CAMPUS,607,605,2,47,41,6,0,0,182,48,789,95,129,1,884,823.87
2018,31,NEW YORK,2,INDEPENDENT,1,PRIVATE,1,4-Year/Grad,445060,800000057566,MERCY COLLEGE - MANHATTAN CAMPUS,550,546,4,49,44,5,0,0,129,33,679,82,119,1,761,708.53
2019,31,NEW YORK,2,INDEPENDENT,1,PRIVATE,1,4-Year/Grad,445060,800000057566,MERCY COLLEGE - MANHATTAN CAMPUS,515,515,0,37,36,1,0,0,113,29,628,66,131,0,694,651.93
2010,01,ALBANY,2,INDEPENDENT,1,PRIVATE,1,4-Year/Grad,445500,800000065114,MID-AMERICA BAPTIST THEOL SEMINARY - NE BRANCH,2,2,0,11,10,1,7,13,0,0,9,24,1,2,33,17.87
2011,01,ALBANY,2,INDEPENDENT,1,PRIVATE,1,4-Year/Grad,445500,800000065114,MID-AMERICA BAPTIST THEOL SEMINARY - NE BRANCH,3,3,0,25,23,2,12,10,0,0,15,35,2,0,50,27.33
2012,01,ALBANY,2,INDEPENDENT,1,PRIVATE,1,4-Year/Grad,445500,800000065114,MID-AMERICA BAPTIST THEOL SEMINARY - NE BRANCH,3,3,0,18,17,1,7,9,0,0,10,27,1,2,37,19.6
2013,01,ALBANY,2,INDEPENDENT,1,PRIVATE,1,4-Year/Grad,445500,800000065114,MID-AMERICA BAPTIST THEOL SEMINARY - NE BRANCH,1,1,0,3,3,0,4,12,0,2,5,17,1,0,22,11.6
2014,01,ALBANY,2,INDEPENDENT,1,PRIVATE,1,4-Year/Grad,445500,800000065114,MID-AMERICA BAPTIST THEOL SEMINARY - NE BRANCH,0,0,0,0,0,0,3,3,0,0,3,3,0,0,6,4.2
2015,01,ALBANY,2,INDEPENDENT,1,PRIVATE,1,4-Year/Grad,445500,800000065114,MID-AMERICA BAPTIST THEOL SEMINARY - NE BRANCH,1,1,0,0,0,0,5,0,0,0,6,0,1,0,6,6
2016,01,ALBANY,2,INDEPENDENT,1,PRIVATE,1,4-Year/Grad,445500,800000065114,MID-AMERICA BAPTIST THEOL SEMINARY - NE BRANCH,1,1,0,0,0,0,0,0,0,0,1,0,1,0,1,1
2010,28,NASSAU,2,INDEPENDENT,1,PRIVATE,1,4-Year/Grad,446500,800000049338,MOLLOY COLLEGE,2511,2497,14,664,620,44,0,0,203,810,2714,1474,388,8,4188,3259.33
2011,28,NASSAU,2,INDEPENDENT,1,PRIVATE,1,4-Year/Grad,446500,800000049338,MOLLOY COLLEGE,2636,2632,4,778,719,59,0,0,201,819,2837,1597,396,7,4434,3423.93
2012,28,NASSAU,2,INDEPENDENT,1,PRIVATE,1,4-Year/Grad,446500,800000049338,MOLLOY COLLEGE,2642,2629,13,802,742,60,0,0,184,854,2826,1656,449,6,4482,3434.93
2013,28,NASSAU,2,INDEPENDENT,1,PRIVATE,1,4-Year/Grad,446500,800000049338,MOLLOY COLLEGE,2693,2689,4,682,633,49,0,0,210,870,2903,1552,495,6,4455,3478.33
2014,28,NASSAU,2,INDEPENDENT,1,PRIVATE,1,4-Year/Grad,446500,800000049338,MOLLOY COLLEGE,2679,2674,5,657,619,38,0,0,234,927,2913,1584,490,2,4497,3502.8
2015,28,NASSAU,2,INDEPENDENT,1,PRIVATE,1,4-Year/Grad,446500,800000049338,MOLLOY COLLEGE,2753,2746,7,672,627,45,0,24,242,1203,2995,1899,538,1,4894,3709.8
2016,28,NASSAU,2,INDEPENDENT,1,PRIVATE,1,4-Year/Grad,446500,800000049338,MOLLOY COLLEGE,2906,2900,6,692,662,30,0,24,290,1157,3196,1873,562,3,5069,3899.07
2017,28,NASSAU,2,INDEPENDENT,1,PRIVATE,1,4-Year/Grad,446500,800000049338,MOLLOY COLLEGE,2800,2798,2,734,707,27,0,23,295,1128,3095,1885,510,4,4980,3800.07
2018,28,NASSAU,2,INDEPENDENT,1,PRIVATE,1,4-Year/Grad,446500,800000049338,MOLLOY COLLEGE,2762,2761,1,677,648,29,0,21,330,1120,3092,1818,592,6,4910,3774.07
2019,28,NASSAU,2,INDEPENDENT,1,PRIVATE,1,4-Year/Grad,446500,800000049338,MOLLOY COLLEGE,2780,2777,3,716,649,67,0,19,339,1259,3119,1994,579,2,5113,3868.87
2016,66,WESTCHESTER,2,INDEPENDENT,1,PRIVATE,0,2-Year,446600,800000084543,MONTEFIORE SCHOOL OF NURSING,4,4,0,111,111,0,0,0,0,0,4,111,0,0,115,41
2018,66,WESTCHESTER,2,INDEPENDENT,1,PRIVATE,0,2-Year,446600,800000084543,MONTEFIORE SCHOOL OF NURSING,23,23,0,129,129,0,0,0,0,0,23,129,0,0,152,66
2019,66,WESTCHESTER,2,INDEPENDENT,1,PRIVATE,0,2-Year,446600,800000084543,MONTEFIORE SCHOOL OF NURSING,20,20,0,130,130,0,0,0,0,0,20,130,0,0,150,63.33
2010,44,ORANGE,2,INDEPENDENT,1,PRIVATE,1,4-Year/Grad,447500,800000040218,MOUNT SAINT MARY COLLEGE,1899,1894,5,400,360,40,0,0,98,303,1997,703,447,29,2700,2251.53
2011,44,ORANGE,2,INDEPENDENT,1,PRIVATE,1,4-Year/Grad,447500,800000040218,MOUNT SAINT MARY COLLEGE,1929,1925,4,417,394,23,0,0,89,274,2018,691,457,15,2709,2266.6
2012,44,ORANGE,2,INDEPENDENT,1,PRIVATE,1,4-Year/Grad,447500,800000040218,MOUNT SAINT MARY COLLEGE,1863,1861,2,423,400,23,0,0,56,239,1919,662,442,14,2581,2155.6
2013,44,ORANGE,2,INDEPENDENT,1,PRIVATE,1,4-Year/Grad,447500,800000040218,MOUNT SAINT MARY COLLEGE,1742,1739,3,461,416,45,0,0,69,284,1811,745,451,29,2556,2078.27
2014,44,ORANGE,2,INDEPENDENT,1,PRIVATE,1,4-Year/Grad,447500,800000040218,MOUNT SAINT MARY COLLEGE,1712,1707,5,411,389,22,0,0,86,270,1798,681,411,3,2479,2043
2015,44,ORANGE,2,INDEPENDENT,1,PRIVATE,1,4-Year/Grad,447500,800000040218,MOUNT SAINT MARY COLLEGE,1780,1780,0,377,360,17,0,0,82,269,1862,646,422,2,2508,2095.27
2016,44,ORANGE,2,INDEPENDENT,1,PRIVATE,1,4-Year/Grad,447500,800000040218,MOUNT SAINT MARY COLLEGE,1750,1748,2,378,358,20,0,0,82,258,1832,636,384,8,2468,2061.2
2017,44,ORANGE,2,INDEPENDENT,1,PRIVATE,1,4-Year/Grad,447500,800000040218,MOUNT SAINT MARY COLLEGE,1737,1736,1,299,294,5,0,0,62,267,1799,566,400,4,2365,2005.47
2018,44,ORANGE,2,INDEPENDENT,1,PRIVATE,1,4-Year/Grad,447500,800000040218,MOUNT SAINT MARY COLLEGE,1675,1674,1,330,322,8,0,0,61,286,1736,616,389,0,2352,1960.4
2019,44,ORANGE,2,INDEPENDENT,1,PRIVATE,1,4-Year/Grad,447500,800000040218,MOUNT SAINT MARY COLLEGE,1596,1596,0,285,274,11,0,0,58,297,1654,582,336,3,2236,1867.8
2010,31,NEW YORK,2,INDEPENDENT,1,PRIVATE,1,4-Year/Grad,448000,800000047185,MT SINAI SCHOOL OF MEDICINE,0,0,0,0,0,0,588,0,484,0,1072,0,0,0,1072,1072
2011,31,NEW YORK,2,INDEPENDENT,1,PRIVATE,1,4-Year/Grad,448000,800000047185,MT SINAI SCHOOL OF MEDICINE,0,0,0,0,0,0,606,0,518,0,1124,0,0,0,1124,1124
2012,31,NEW YORK,2,INDEPENDENT,1,PRIVATE,1,4-Year/Grad,448000,800000047185,MT SINAI SCHOOL OF MEDICINE,0,0,0,0,0,0,568,0,586,0,1154,0,0,0,1154,1154
2013,31,NEW YORK,2,INDEPENDENT,1,PRIVATE,1,4-Year/Grad,448000,800000047185,MT SINAI SCHOOL OF MEDICINE,0,0,0,0,0,0,550,0,540,0,1090,0,0,0,1090,1090
2014,31,NEW YORK,2,INDEPENDENT,1,PRIVATE,1,4-Year/Grad,448000,800000047185,MT SINAI SCHOOL OF MEDICINE,0,0,0,0,0,0,556,0,518,0,1074,0,0,0,1074,1074
2015,31,NEW YORK,2,INDEPENDENT,1,PRIVATE,1,4-Year/Grad,448000,800000047185,MT SINAI SCHOOL OF MEDICINE,0,0,0,0,0,0,556,0,594,0,1150,0,0,0,1150,1150
2016,31,NEW YORK,2,INDEPENDENT,1,PRIVATE,1,4-Year/Grad,448000,800000047185,MT SINAI SCHOOL OF MEDICINE,0,0,0,0,0,0,562,0,624,0,1186,0,0,0,1186,1186
2017,31,NEW YORK,2,INDEPENDENT,1,PRIVATE,1,4-Year/Grad,448000,800000047185,MT SINAI SCHOOL OF MEDICINE,0,0,0,0,0,0,561,0,647,0,1208,0,0,0,1208,1208
2010,66,WESTCHESTER,2,INDEPENDENT,1,PRIVATE,0,2-Year,448200,800000035180,DOROTHEA HOPFER SCH NURS AT MT VERN,16,16,0,100,100,0,0,0,0,0,16,100,0,0,116,49.33
2011,66,WESTCHESTER,2,INDEPENDENT,1,PRIVATE,0,2-Year,448200,800000035180,DOROTHEA HOPFER SCH NURS AT MT VERN,10,10,0,111,111,0,0,0,0,0,10,111,0,0,121,47
2012,66,WESTCHESTER,2,INDEPENDENT,1,PRIVATE,0,2-Year,448200,800000035180,DOROTHEA HOPFER SCH NURS AT MT VERN,2,2,0,122,122,0,0,0,0,0,2,122,0,0,124,42.67
2013,66,WESTCHESTER,2,INDEPENDENT,1,PRIVATE,0,2-Year,448200,800000035180,DOROTHEA HOPFER SCH NURS AT MT VERN,3,3,0,126,126,0,0,0,0,0,3,126,0,0,129,45
2010,26,MONROE,2,INDEPENDENT,1,PRIVATE,1,4-Year/Grad,448500,800000050295,NAZARETH COLLEGE OF ROCHESTER,2019,1999,20,173,137,36,116,0,396,553,2531,726,467,3,3257,2809.87
2011,26,MONROE,2,INDEPENDENT,1,PRIVATE,1,4-Year/Grad,448500,800000050295,NAZARETH COLLEGE OF ROCHESTER,1976,1957,19,155,124,31,126,1,347,497,2449,653,439,0,3102,2699.87
2012,26,MONROE,2,INDEPENDENT,1,PRIVATE,1,4-Year/Grad,448500,800000050295,NAZARETH COLLEGE OF ROCHESTER,1926,1913,13,133,108,25,136,2,303,410,2365,545,472,0,2910,2574.13
2013,26,MONROE,2,INDEPENDENT,1,PRIVATE,1,4-Year/Grad,448500,800000050295,NAZARETH COLLEGE OF ROCHESTER,1869,1858,11,133,105,28,147,1,277,396,2293,530,423,0,2823,2496.13
2014,26,MONROE,2,INDEPENDENT,1,PRIVATE,1,4-Year/Grad,448500,800000050295,NAZARETH COLLEGE OF ROCHESTER,1885,1871,14,126,100,26,160,0,260,387,2305,513,476,0,2818,2501.8
2015,26,MONROE,2,INDEPENDENT,1,PRIVATE,1,4-Year/Grad,448500,800000050295,NAZARETH COLLEGE OF ROCHESTER,1925,1922,3,134,107,27,168,0,278,366,2371,500,519,2,2871,2562.07
2016,26,MONROE,2,INDEPENDENT,1,PRIVATE,1,4-Year/Grad,448500,800000050295,NAZARETH COLLEGE OF ROCHESTER,2002,1996,6,114,86,28,163,0,243,361,2408,475,517,0,2883,2590.4
2017,26,MONROE,2,INDEPENDENT,1,PRIVATE,1,4-Year/Grad,448500,800000050295,NAZARETH COLLEGE OF ROCHESTER,2050,2046,4,95,80,15,158,1,261,335,2469,431,550,0,2900,2635.07
2018,26,MONROE,2,INDEPENDENT,1,PRIVATE,1,4-Year/Grad,448500,800000050295,NAZARETH COLLEGE OF ROCHESTER,2137,2137,0,93,76,17,161,0,267,329,2565,422,544,1,2987,2727.6
2019,26,MONROE,2,INDEPENDENT,1,PRIVATE,1,4-Year/Grad,448500,800000050295,NAZARETH COLLEGE OF ROCHESTER,2143,2140,3,102,86,16,160,0,249,325,2552,427,516,0,2979,2716
2010,28,NASSAU,2,INDEPENDENT,1,PRIVATE,1,4-Year/Grad,448700,800000048940,NEW YORK COLLEGE OF HEALTH PROFESSIONS,297,296,1,397,388,9,0,0,22,18,319,415,49,39,734,458.53
2011,28,NASSAU,2,INDEPENDENT,1,PRIVATE,1,4-Year/Grad,448700,800000048940,NEW YORK COLLEGE OF HEALTH PROFESSIONS,313,313,0,366,353,13,0,0,24,14,337,380,64,31,717,464.6
2012,28,NASSAU,2,INDEPENDENT,1,PRIVATE,1,4-Year/Grad,448700,800000048940,NEW YORK COLLEGE OF HEALTH PROFESSIONS,393,393,0,342,335,7,0,0,22,11,415,353,90,37,768,533.4
2013,28,NASSAU,2,INDEPENDENT,1,PRIVATE,1,4-Year/Grad,448700,800000048940,NEW YORK COLLEGE OF HEALTH PROFESSIONS,445,444,1,296,289,7,0,0,18,17,463,313,43,22,776,568.47
2014,28,NASSAU,2,INDEPENDENT,1,PRIVATE,1,4-Year/Grad,448700,800000048940,NEW YORK COLLEGE OF HEALTH PROFESSIONS,380,380,0,318,313,5,0,0,26,14,406,332,32,16,738,517.6
2015,28,NASSAU,2,INDEPENDENT,1,PRIVATE,1,4-Year/Grad,448700,800000048940,NEW YORK COLLEGE OF HEALTH PROFESSIONS,267,267,0,498,496,2,0,0,51,101,318,599,21,7,917,524.4
2016,28,NASSAU,2,INDEPENDENT,1,PRIVATE,1,4-Year/Grad,448700,800000048940,NEW YORK COLLEGE OF HEALTH PROFESSIONS,194,193,1,163,162,1,0,0,109,92,303,255,27,8,558,394.13
2017,28,NASSAU,2,INDEPENDENT,1,PRIVATE,1,4-Year/Grad,448700,800000048940,NEW YORK COLLEGE OF HEALTH PROFESSIONS,200,199,1,122,122,0,0,0,83,128,283,250,36,17,533,374.87
2018,28,NASSAU,2,INDEPENDENT,1,PRIVATE,1,4-Year/Grad,448700,800000048940,NEW YORK COLLEGE OF HEALTH PROFESSIONS,237,237,0,173,171,2,0,0,85,41,322,214,33,10,536,396.07
2019,28,NASSAU,2,INDEPENDENT,1,PRIVATE,1,4-Year/Grad,448700,800000048940,NEW YORK COLLEGE OF HEALTH PROFESSIONS,285,285,0,119,118,1,0,0,44,32,329,151,22,7,480,381.47
2010,31,NEW YORK,2,INDEPENDENT,1,PRIVATE,1,4-Year/Grad,449000,800000047851,THE NEW SCHOOL,6047,5980,67,1028,815,213,0,0,2667,1026,8714,2054,1175,15,10768,9467.07
2011,31,NEW YORK,2,INDEPENDENT,1,PRIVATE,1,4-Year/Grad,449000,800000047851,THE NEW SCHOOL,6080,6023,57,1109,812,297,0,0,2661,1066,8741,2175,1079,57,10916,9537.07
2012,31,NEW YORK,2,INDEPENDENT,1,PRIVATE,1,4-Year/Grad,449000,800000047851,THE NEW SCHOOL,5998,5933,65,1089,825,264,0,0,2491,1119,8489,2208,1096,31,10697,9299.6
2013,31,NEW YORK,2,INDEPENDENT,1,PRIVATE,1,4-Year/Grad,449000,800000047851,THE NEW SCHOOL,5971,5899,72,903,779,124,0,0,2537,987,8508,1890,997,42,10398,9203.8
2014,31,NEW YORK,2,INDEPENDENT,1,PRIVATE,1,4-Year/Grad,449000,800000047851,THE NEW SCHOOL,5933,5795,138,916,809,107,0,0,2638,903,8571,1819,1168,38,10390,9237.53
2015,31,NEW YORK,2,INDEPENDENT,1,PRIVATE,1,4-Year/Grad,449000,800000047851,THE NEW SCHOOL,5972,5876,96,916,804,112,0,0,2557,832,8529,1748,1260,34,10277,9167.13
2016,31,NEW YORK,2,INDEPENDENT,1,PRIVATE,1,4-Year/Grad,449000,800000047851,THE NEW SCHOOL,6238,6195,43,1673,829,844,0,0,2464,761,8702,2434,1572,41,11136,9564.07
2017,31,NEW YORK,2,INDEPENDENT,1,PRIVATE,1,4-Year/Grad,449000,800000047851,THE NEW SCHOOL,6276,6235,41,1509,749,760,0,0,2600,665,8876,2174,1530,31,11050,9645
2018,31,NEW YORK,2,INDEPENDENT,1,PRIVATE,1,4-Year/Grad,449000,800000047851,THE NEW SCHOOL,6622,6614,8,799,691,108,0,0,2618,495,9240,1294,1763,34,10534,9704.33
2019,31,NEW YORK,2,INDEPENDENT,1,PRIVATE,1,4-Year/Grad,449000,800000047851,THE NEW SCHOOL,6658,6655,3,704,626,78,0,0,2591,424,9249,1128,1432,35,10377,9653.27
2010,31,NEW YORK,2,INDEPENDENT,1,PRIVATE,1,4-Year/Grad,449100,800000065115,NEW YORK STUDIO SCHOOL,0,0,0,0,0,0,0,0,30,2,30,2,0,0,32,30.8
2011,31,NEW YORK,2,INDEPENDENT,1,PRIVATE,1,4-Year/Grad,449100,800000065115,NEW YORK STUDIO SCHOOL,0,0,0,0,0,0,0,0,30,1,30,1,0,0,31,30.4
2012,31,NEW YORK,2,INDEPENDENT,1,PRIVATE,1,4-Year/Grad,449100,800000065115,NEW YORK STUDIO SCHOOL,0,0,0,0,0,0,0,0,26,0,26,0,0,0,26,26
2013,31,NEW YORK,2,INDEPENDENT,1,PRIVATE,1,4-Year/Grad,449100,800000065115,NEW YORK STUDIO SCHOOL,0,0,0,0,0,0,0,0,26,0,26,0,0,0,26,26
2014,31,NEW YORK,2,INDEPENDENT,1,PRIVATE,1,4-Year/Grad,449100,800000065115,NEW YORK STUDIO SCHOOL,0,0,0,0,0,0,0,0,23,0,23,0,0,0,23,23
2015,31,NEW YORK,2,INDEPENDENT,1,PRIVATE,1,4-Year/Grad,449100,800000065115,NEW YORK STUDIO SCHOOL,0,0,0,0,0,0,0,0,19,0,19,0,0,0,19,19
2016,31,NEW YORK,2,INDEPENDENT,1,PRIVATE,1,4-Year/Grad,449100,800000065115,NEW YORK STUDIO SCHOOL,0,0,0,0,0,0,0,0,28,0,28,0,0,0,28,28
2017,31,NEW YORK,2,INDEPENDENT,1,PRIVATE,1,4-Year/Grad,449100,800000065115,NEW YORK STUDIO SCHOOL,0,0,0,0,0,0,0,0,28,0,28,0,0,0,28,28
2018,31,NEW YORK,2,INDEPENDENT,1,PRIVATE,1,4-Year/Grad,449100,800000065115,NEW YORK STUDIO SCHOOL,0,0,0,0,0,0,0,0,29,0,29,0,0,0,29,29
2019,31,NEW YORK,2,INDEPENDENT,1,PRIVATE,1,4-Year/Grad,449100,800000065115,NEW YORK STUDIO SCHOOL,0,0,0,0,0,0,0,0,25,0,25,0,0,0,25,25
2010,56,SENECA,2,INDEPENDENT,1,PRIVATE,1,4-Year/Grad,449500,800000038125,NY CHIROPRACTIC COLLEGE,0,0,0,22,22,0,672,0,51,88,723,110,0,0,833,765.53
2011,56,SENECA,2,INDEPENDENT,1,PRIVATE,1,4-Year/Grad,449500,800000038125,NY CHIROPRACTIC COLLEGE,0,0,0,24,24,0,643,1,45,149,688,174,0,0,862,756
2012,56,SENECA,2,INDEPENDENT,1,PRIVATE,1,4-Year/Grad,449500,800000038125,NY CHIROPRACTIC COLLEGE,0,0,0,20,20,0,660,2,46,212,706,234,0,0,940,798.27
2013,56,SENECA,2,INDEPENDENT,1,PRIVATE,1,4-Year/Grad,449500,800000038125,NY CHIROPRACTIC COLLEGE,0,0,0,24,24,0,667,2,56,198,723,224,0,0,947,811
2014,56,SENECA,2,INDEPENDENT,1,PRIVATE,1,4-Year/Grad,449500,800000038125,NY CHIROPRACTIC COLLEGE,0,0,0,20,20,0,665,2,57,241,722,263,0,0,985,825.87
2015,56,SENECA,2,INDEPENDENT,1,PRIVATE,1,4-Year/Grad,449500,800000038125,NY CHIROPRACTIC COLLEGE,0,0,0,0,0,0,640,0,45,257,685,257,0,0,942,787.8
2016,56,SENECA,2,INDEPENDENT,1,PRIVATE,1,4-Year/Grad,449500,800000038125,NY CHIROPRACTIC COLLEGE,0,0,0,27,27,0,634,0,43,263,677,290,0,0,967,791.2
2017,56,SENECA,2,INDEPENDENT,1,PRIVATE,1,4-Year/Grad,449500,800000038125,NY CHIROPRACTIC COLLEGE,0,0,0,18,18,0,623,0,34,269,657,287,0,0,944,770.6
2018,56,SENECA,2,INDEPENDENT,1,PRIVATE,1,4-Year/Grad,449500,800000038125,NY CHIROPRACTIC COLLEGE,0,0,0,12,12,0,603,3,33,256,636,271,0,0,907,743.6
2019,56,SENECA,2,INDEPENDENT,1,PRIVATE,1,4-Year/Grad,449500,800000038125,NY CHIROPRACTIC COLLEGE,0,0,0,0,0,0,564,2,11,235,575,237,0,0,812,669.8
2010,31,NEW YORK,2,INDEPENDENT,1,PRIVATE,1,4-Year/Grad,450000,800000047066,NEW YORK COLLEGE OF PODIATRIC MEDICINE,0,0,0,0,0,0,347,4,0,0,347,4,0,0,351,348.6
2011,31,NEW YORK,2,INDEPENDENT,1,PRIVATE,1,4-Year/Grad,450000,800000047066,NEW YORK COLLEGE OF PODIATRIC MEDICINE,0,0,0,0,0,0,356,1,0,0,356,1,0,0,357,356.4
2012,31,NEW YORK,2,INDEPENDENT,1,PRIVATE,1,4-Year/Grad,450000,800000047066,NEW YORK COLLEGE OF PODIATRIC MEDICINE,0,0,0,0,0,0,367,4,0,0,367,4,0,0,371,368.6
2013,31,NEW YORK,2,INDEPENDENT,1,PRIVATE,1,4-Year/Grad,450000,800000047066,NEW YORK COLLEGE OF PODIATRIC MEDICINE,0,0,0,0,0,0,378,2,0,0,378,2,0,0,380,378.8
2014,31,NEW YORK,2,INDEPENDENT,1,PRIVATE,1,4-Year/Grad,450000,800000047066,NEW YORK COLLEGE OF PODIATRIC MEDICINE,0,0,0,0,0,0,379,1,0,0,379,1,0,0,380,379.4
2015,31,NEW YORK,2,INDEPENDENT,1,PRIVATE,1,4-Year/Grad,450000,800000047066,NEW YORK COLLEGE OF PODIATRIC MEDICINE,0,0,0,0,0,0,386,3,0,0,386,3,0,0,389,387.2
2016,31,NEW YORK,2,INDEPENDENT,1,PRIVATE,1,4-Year/Grad,450000,800000047066,NEW YORK COLLEGE OF PODIATRIC MEDICINE,0,0,0,0,0,0,368,2,0,0,368,2,0,0,370,368.8
2017,31,NEW YORK,2,INDEPENDENT,1,PRIVATE,1,4-Year/Grad,450000,800000047066,NEW YORK COLLEGE OF PODIATRIC MEDICINE,0,0,0,0,0,0,393,3,0,0,393,3,0,0,396,394.2
2018,31,NEW YORK,2,INDEPENDENT,1,PRIVATE,1,4-Year/Grad,450000,800000047066,NEW YORK COLLEGE OF PODIATRIC MEDICINE,0,0,0,0,0,0,348,2,0,0,348,2,0,0,350,348.8
2019,31,NEW YORK,2,INDEPENDENT,1,PRIVATE,1,4-Year/Grad,450000,800000047066,NEW YORK COLLEGE OF PODIATRIC MEDICINE,0,0,0,0,0,0,329,1,0,0,329,1,0,0,330,329.4
2010,28,NASSAU,2,INDEPENDENT,1,PRIVATE,1,4-Year/Grad,450100,800000062131,NEW YORK COLLEGE OF TRADITIONAL CHINESE MEDICINE,54,54,0,16,11,5,0,0,43,43,97,59,0,0,156,119.53
2011,28,NASSAU,2,INDEPENDENT,1,PRIVATE,1,4-Year/Grad,450100,800000062131,NEW YORK COLLEGE OF TRADITIONAL CHINESE MEDICINE,38,38,0,20,18,2,0,0,50,39,88,59,0,0,147,110.27
2012,28,NASSAU,2,INDEPENDENT,1,PRIVATE,1,4-Year/Grad,450100,800000062131,NEW YORK COLLEGE OF TRADITIONAL CHINESE MEDICINE,42,42,0,17,12,5,0,0,46,36,88,53,0,0,141,108.07
2013,28,NASSAU,2,INDEPENDENT,1,PRIVATE,1,4-Year/Grad,450100,800000062131,NEW YORK COLLEGE OF TRADITIONAL CHINESE MEDICINE,47,47,0,34,17,17,0,0,33,36,80,70,0,0,150,105.73
2014,28,NASSAU,2,INDEPENDENT,1,PRIVATE,1,4-Year/Grad,450100,800000062131,NEW YORK COLLEGE OF TRADITIONAL CHINESE MEDICINE,56,56,0,33,22,11,0,0,38,39,94,72,0,0,166,120.6
2015,28,NASSAU,2,INDEPENDENT,1,PRIVATE,1,4-Year/Grad,450100,800000062131,NEW YORK COLLEGE OF TRADITIONAL CHINESE MEDICINE,33,33,0,36,30,6,0,0,77,38,110,74,0,0,184,137.2
2016,28,NASSAU,2,INDEPENDENT,1,PRIVATE,1,4-Year/Grad,450100,800000062131,NEW YORK COLLEGE OF TRADITIONAL CHINESE MEDICINE,50,50,0,27,23,4,0,0,68,41,118,68,0,0,186,143.4
2017,28,NASSAU,2,INDEPENDENT,1,PRIVATE,1,4-Year/Grad,450100,800000062131,NEW YORK COLLEGE OF TRADITIONAL CHINESE MEDICINE,49,49,0,20,16,4,0,0,76,50,125,70,0,0,195,151.67
2018,28,NASSAU,2,INDEPENDENT,1,PRIVATE,1,4-Year/Grad,450100,800000062131,NEW YORK COLLEGE OF TRADITIONAL CHINESE MEDICINE,44,44,0,23,21,2,0,0,72,46,116,69,0,0,185,142.07
2019,28,NASSAU,2,INDEPENDENT,1,PRIVATE,1,4-Year/Grad,450100,800000062131,NEW YORK COLLEGE OF TRADITIONAL CHINESE MEDICINE,58,58,0,20,20,0,0,0,62,55,120,75,0,0,195,148.67
2016,31,NEW YORK,2,INDEPENDENT,1,PRIVATE,1,4-Year/Grad,450520,800000047357,NEW YORK INSTITUTE FOR TECHNOLOGY-MANHATTAN CAMPUS,1339,1335,4,205,192,13,0,0,825,329,2164,534,317,26,2698,2363.93
2017,31,NEW YORK,2,INDEPENDENT,1,PRIVATE,1,4-Year/Grad,450520,800000047357,NEW YORK INSTITUTE FOR TECHNOLOGY-MANHATTAN CAMPUS,1446,1442,4,228,191,37,0,0,763,259,2209,487,402,26,2696,2388.6
2018,31,NEW YORK,2,INDEPENDENT,1,PRIVATE,1,4-Year/Grad,450520,800000047357,NEW YORK INSTITUTE FOR TECHNOLOGY-MANHATTAN CAMPUS,1498,1497,1,197,173,24,0,0,601,215,2099,412,386,31,2511,2250.67
2019,31,NEW YORK,2,INDEPENDENT,1,PRIVATE,1,4-Year/Grad,450520,800000047357,NEW YORK INSTITUTE FOR TECHNOLOGY-MANHATTAN CAMPUS,1502,1500,2,164,136,28,0,0,569,178,2071,342,342,21,2413,2196.87
2010,28,NASSAU,2,INDEPENDENT,1,PRIVATE,1,4-Year/Grad,450530,800000048817,NEW YORK INSTITUTE OF TECHNOLOGY OLD WESTBURY CAMPUS,4281,4259,22,747,642,105,1175,0,1144,1064,6600,1811,899,44,8411,7274.6
2011,28,NASSAU,2,INDEPENDENT,1,PRIVATE,1,4-Year/Grad,450530,800000048817,NEW YORK INSTITUTE OF TECHNOLOGY OLD WESTBURY CAMPUS,4098,4005,93,812,669,143,1186,0,1057,1028,6341,1840,827,38,8181,7022.87
2012,28,NASSAU,2,INDEPENDENT,1,PRIVATE,1,4-Year/Grad,450530,800000048817,NEW YORK INSTITUTE OF TECHNOLOGY OLD WESTBURY CAMPUS,4017,3932,85,779,645,134,1190,0,1021,876,6228,1655,850,54,7883,6838.07
2013,28,NASSAU,2,INDEPENDENT,1,PRIVATE,1,4-Year/Grad,450530,800000048817,NEW YORK INSTITUTE OF TECHNOLOGY OLD WESTBURY CAMPUS,3704,3639,65,713,668,45,1300,0,1024,765,6028,1478,772,57,7506,6571.67
2014,28,NASSAU,2,INDEPENDENT,1,PRIVATE,1,4-Year/Grad,450530,800000048817,NEW YORK INSTITUTE OF TECHNOLOGY OLD WESTBURY CAMPUS,3727,3618,109,576,542,34,1319,0,1426,836,6472,1412,679,33,7884,6998.4
2015,28,NASSAU,2,INDEPENDENT,1,PRIVATE,1,4-Year/Grad,450530,800000048817,NEW YORK INSTITUTE OF TECHNOLOGY OLD WESTBURY CAMPUS,3540,3480,60,494,470,24,1340,0,1745,929,6625,1423,699,44,8048,7161.27
2016,28,NASSAU,2,INDEPENDENT,1,PRIVATE,1,4-Year/Grad,450530,800000048817,NEW YORK INSTITUTE OF TECHNOLOGY OLD WESTBURY CAMPUS,1874,1874,0,191,177,14,1234,0,983,562,4091,753,364,7,4844,4379.47
2017,28,NASSAU,2,INDEPENDENT,1,PRIVATE,1,4-Year/Grad,450530,800000048817,NEW YORK INSTITUTE OF TECHNOLOGY OLD WESTBURY CAMPUS,1788,1787,1,226,199,27,1366,2,618,493,3772,721,455,11,4493,4045.33
2018,28,NASSAU,2,INDEPENDENT,1,PRIVATE,1,4-Year/Grad,450530,800000048817,NEW YORK INSTITUTE OF TECHNOLOGY OLD WESTBURY CAMPUS,1752,1751,1,201,171,30,1370,2,539,440,3661,643,458,22,4304,3904.8
2019,28,NASSAU,2,INDEPENDENT,1,PRIVATE,1,4-Year/Grad,450530,800000048817,NEW YORK INSTITUTE OF TECHNOLOGY OLD WESTBURY CAMPUS,1855,1855,0,173,151,22,1377,0,516,425,3748,598,474,15,4346,3975.67
2010,31,NEW YORK,2,INDEPENDENT,1,PRIVATE,1,4-Year/Grad,451000,800000047840,NEW YORK LAW SCHOOL,0,0,0,0,0,0,1494,429,55,63,1549,492,0,0,2041,1745.8
2011,31,NEW YORK,2,INDEPENDENT,1,PRIVATE,1,4-Year/Grad,451000,800000047840,NEW YORK LAW SCHOOL,0,0,0,0,0,0,1365,400,45,50,1410,450,0,0,1860,1590
2012,31,NEW YORK,2,INDEPENDENT,1,PRIVATE,1,4-Year/Grad,451000,800000047840,NEW YORK LAW SCHOOL,0,0,0,0,0,0,1128,411,34,71,1162,482,0,0,1644,1354.8
2013,31,NEW YORK,2,INDEPENDENT,1,PRIVATE,1,4-Year/Grad,451000,800000047840,NEW YORK LAW SCHOOL,0,0,0,0,0,0,866,350,25,66,891,416,0,0,1307,1057.4
2014,31,NEW YORK,2,INDEPENDENT,1,PRIVATE,1,4-Year/Grad,451000,800000047840,NEW YORK LAW SCHOOL,0,0,0,0,0,0,660,308,20,44,680,352,0,0,1032,820.8
2015,31,NEW YORK,2,INDEPENDENT,1,PRIVATE,1,4-Year/Grad,451000,800000047840,NEW YORK LAW SCHOOL,0,0,0,0,0,0,578,315,7,31,585,346,0,0,931,723.4
2016,31,NEW YORK,2,INDEPENDENT,1,PRIVATE,1,4-Year/Grad,451000,800000047840,NEW YORK LAW SCHOOL,0,0,0,0,0,0,620,242,12,15,632,257,0,0,889,734.8
2017,31,NEW YORK,2,INDEPENDENT,1,PRIVATE,1,4-Year/Grad,451000,800000047840,NEW YORK LAW SCHOOL,0,0,0,0,0,0,729,237,8,21,737,258,0,0,995,840.2
2018,31,NEW YORK,2,INDEPENDENT,1,PRIVATE,1,4-Year/Grad,451000,800000047840,NEW YORK LAW SCHOOL,0,0,0,0,0,0,785,231,6,20,791,251,0,0,1042,891.4
2019,31,NEW YORK,2,INDEPENDENT,1,PRIVATE,1,4-Year/Grad,451000,800000047840,NEW YORK LAW SCHOOL,0,0,0,0,0,0,872,208,2,20,874,228,0,0,1102,965.2
2010,66,WESTCHESTER,2,INDEPENDENT,1,PRIVATE,1,4-Year/Grad,451500,800000035309,NY MEDICAL COLLEGE,0,0,0,0,0,0,882,0,268,298,1150,298,0,0,1448,1269.2
2011,66,WESTCHESTER,2,INDEPENDENT,1,PRIVATE,1,4-Year/Grad,451500,800000035309,NY MEDICAL COLLEGE,0,0,0,0,0,0,876,0,254,308,1130,308,0,0,1438,1253.2
2012,66,WESTCHESTER,2,INDEPENDENT,1,PRIVATE,1,4-Year/Grad,451500,800000035309,NY MEDICAL COLLEGE,0,0,0,0,0,0,902,0,258,323,1160,323,0,0,1483,1289.2
2013,66,WESTCHESTER,2,INDEPENDENT,1,PRIVATE,1,4-Year/Grad,451500,800000035309,NY MEDICAL COLLEGE,0,0,0,0,0,0,898,0,241,288,1139,288,0,0,1427,1254.2
2014,66,WESTCHESTER,2,INDEPENDENT,1,PRIVATE,1,4-Year/Grad,451500,800000035309,NY MEDICAL COLLEGE,0,0,0,0,0,0,925,0,257,300,1182,300,0,0,1482,1302
2015,66,WESTCHESTER,2,INDEPENDENT,1,PRIVATE,1,4-Year/Grad,451500,800000035309,NY MEDICAL COLLEGE,0,0,0,0,0,0,937,0,237,252,1174,252,0,0,1426,1274.8
2016,66,WESTCHESTER,2,INDEPENDENT,1,PRIVATE,1,4-Year/Grad,451500,800000035309,NY MEDICAL COLLEGE,0,0,0,0,0,0,965,0,230,273,1195,273,0,0,1468,1304.2
2017,66,WESTCHESTER,2,INDEPENDENT,1,PRIVATE,1,4-Year/Grad,451500,800000035309,NY MEDICAL COLLEGE,0,0,0,0,0,0,991,0,242,265,1233,265,0,0,1498,1339
2018,66,WESTCHESTER,2,INDEPENDENT,1,PRIVATE,1,4-Year/Grad,451500,800000035309,NY MEDICAL COLLEGE,0,0,0,0,0,0,978,0,234,250,1212,250,0,0,1462,1312
2019,66,WESTCHESTER,2,INDEPENDENT,1,PRIVATE,1,4-Year/Grad,451500,800000035309,NY MEDICAL COLLEGE,0,0,0,0,0,0,991,0,242,310,1233,310,0,0,1543,1357
2010,31,NEW YORK,2,INDEPENDENT,1,PRIVATE,1,4-Year/Grad,452000,800000047842,NY SCHOOL OF INTERIOR DESIGN,191,189,2,441,338,103,0,0,102,2,293,443,26,12,736,440.8
2011,31,NEW YORK,2,INDEPENDENT,1,PRIVATE,1,4-Year/Grad,452000,800000047842,NY SCHOOL OF INTERIOR DESIGN,170,169,1,384,291,93,0,0,141,3,311,387,11,7,698,440.2
2012,31,NEW YORK,2,INDEPENDENT,1,PRIVATE,1,4-Year/Grad,452000,800000047842,NY SCHOOL OF INTERIOR DESIGN,164,164,0,334,261,73,0,0,150,3,314,337,16,10,651,426.53
2013,31,NEW YORK,2,INDEPENDENT,1,PRIVATE,1,4-Year/Grad,452000,800000047842,NY SCHOOL OF INTERIOR DESIGN,158,158,0,290,232,58,0,0,133,5,291,295,21,11,586,389.67
2014,31,NEW YORK,2,INDEPENDENT,1,PRIVATE,1,4-Year/Grad,452000,800000047842,NY SCHOOL OF INTERIOR DESIGN,145,145,0,270,208,62,0,0,124,0,269,270,13,8,539,359
2015,31,NEW YORK,2,INDEPENDENT,1,PRIVATE,1,4-Year/Grad,452000,800000047842,NY SCHOOL OF INTERIOR DESIGN,128,128,0,253,206,47,0,0,154,3,282,256,4,8,538,367.53
2016,31,NEW YORK,2,INDEPENDENT,1,PRIVATE,1,4-Year/Grad,452000,800000047842,NY SCHOOL OF INTERIOR DESIGN,113,113,0,249,192,57,0,0,178,5,291,254,10,7,545,376
2017,31,NEW YORK,2,INDEPENDENT,1,PRIVATE,1,4-Year/Grad,452000,800000047842,NY SCHOOL OF INTERIOR DESIGN,101,100,1,267,207,60,0,0,170,3,271,270,13,12,541,361.2
2018,31,NEW YORK,2,INDEPENDENT,1,PRIVATE,1,4-Year/Grad,452000,800000047842,NY SCHOOL OF INTERIOR DESIGN,119,119,0,259,230,29,0,0,158,1,277,260,13,5,537,363.73
2019,31,NEW YORK,2,INDEPENDENT,1,PRIVATE,1,4-Year/Grad,452000,800000047842,NY SCHOOL OF INTERIOR DESIGN,126,126,0,291,250,41,0,0,169,2,295,293,15,8,588,392.8
2010,31,NEW YORK,2,INDEPENDENT,1,PRIVATE,1,4-Year/Grad,452500,800000047844,NEW YORK THEOLOGICAL SEMINARY,0,0,0,0,0,0,142,129,0,145,142,274,0,0,416,251.6
2011,31,NEW YORK,2,INDEPENDENT,1,PRIVATE,1,4-Year/Grad,452500,800000047844,NEW YORK THEOLOGICAL SEMINARY,0,0,0,0,0,0,161,94,0,136,161,230,0,0,391,253
2012,31,NEW YORK,2,INDEPENDENT,1,PRIVATE,1,4-Year/Grad,452500,800000047844,NEW YORK THEOLOGICAL SEMINARY,0,0,0,0,0,0,193,59,0,140,193,199,0,0,392,272.6
2013,31,NEW YORK,2,INDEPENDENT,1,PRIVATE,1,4-Year/Grad,452500,800000047844,NEW YORK THEOLOGICAL SEMINARY,0,0,0,0,0,0,135,106,0,161,135,267,0,0,402,241.8
2014,31,NEW YORK,2,INDEPENDENT,1,PRIVATE,1,4-Year/Grad,452500,800000047844,NEW YORK THEOLOGICAL SEMINARY,0,0,0,0,0,0,119,139,0,129,119,268,0,0,387,226.2
2015,31,NEW YORK,2,INDEPENDENT,1,PRIVATE,1,4-Year/Grad,452500,800000047844,NEW YORK THEOLOGICAL SEMINARY,0,0,0,0,0,0,174,55,97,0,271,55,0,0,326,293
2016,31,NEW YORK,2,INDEPENDENT,1,PRIVATE,1,4-Year/Grad,452500,800000047844,NEW YORK THEOLOGICAL SEMINARY,0,0,0,0,0,0,191,50,78,27,269,77,0,0,346,299.8
2017,31,NEW YORK,2,INDEPENDENT,1,PRIVATE,1,4-Year/Grad,452500,800000047844,NEW YORK THEOLOGICAL SEMINARY,0,0,0,0,0,0,173,48,89,38,262,86,0,0,348,296.4
2018,31,NEW YORK,2,INDEPENDENT,1,PRIVATE,1,4-Year/Grad,452500,800000047844,NEW YORK THEOLOGICAL SEMINARY,0,0,0,0,0,0,115,46,84,52,199,98,0,0,297,238.2
2010,31,NEW YORK,2,INDEPENDENT,1,PRIVATE,1,4-Year/Grad,453000,800000047869,NEW YORK UNIVERSITY,20809,20477,332,1281,1162,119,3406,51,9660,8583,33875,9915,5000,16,43790,37755.6
2011,31,NEW YORK,2,INDEPENDENT,1,PRIVATE,1,4-Year/Grad,453000,800000047869,NEW YORK UNIVERSITY,21025,20673,352,1255,1146,109,3484,28,9689,8430,34198,9713,4867,15,43911,37999.53
2012,31,NEW YORK,2,INDEPENDENT,1,PRIVATE,1,4-Year/Grad,453000,800000047869,NEW YORK UNIVERSITY,21247,20950,297,1251,1130,121,3450,11,10267,8290,34964,9552,5124,16,44516,38701.4
2013,31,NEW YORK,2,INDEPENDENT,1,PRIVATE,1,4-Year/Grad,453000,800000047869,NEW YORK UNIVERSITY,21365,21081,284,1250,1091,159,3515,21,10216,8232,35096,9503,5168,39,44599,38813.87
2014,31,NEW YORK,2,INDEPENDENT,1,PRIVATE,1,4-Year/Grad,453000,800000047869,NEW YORK UNIVERSITY,23715,23447,268,1270,1086,184,3516,25,12667,8081,39898,9376,5860,53,49274,43563.73
2015,31,NEW YORK,2,INDEPENDENT,1,PRIVATE,1,4-Year/Grad,453000,800000047869,NEW YORK UNIVERSITY,24480,24252,228,1242,1059,183,3483,20,12814,7988,40777,9250,5886,31,50027,44394.2
2016,31,NEW YORK,2,INDEPENDENT,1,PRIVATE,1,4-Year/Grad,453000,800000047869,NEW YORK UNIVERSITY,24888,24701,187,1247,1011,236,3442,25,13044,7904,41374,9176,6078,55,50550,44961.27
2017,31,NEW YORK,2,INDEPENDENT,1,PRIVATE,1,4-Year/Grad,453000,800000047869,NEW YORK UNIVERSITY,25347,25175,172,1070,879,191,3411,13,13566,7716,42324,8799,6004,18,51123,45772.27
2018,31,NEW YORK,2,INDEPENDENT,1,PRIVATE,1,4-Year/Grad,453000,800000047869,NEW YORK UNIVERSITY,25725,25520,205,1008,819,189,3390,24,14025,7675,43140,8707,6160,13,51847,46555.6
2019,31,NEW YORK,2,INDEPENDENT,1,PRIVATE,1,4-Year/Grad,453000,800000047869,NEW YORK UNIVERSITY,25872,25696,176,1109,917,192,3357,11,16137,6399,45366,7519,5739,13,52885,48299.67
2010,40,NIAGARA,2,INDEPENDENT,1,PRIVATE,1,4-Year/Grad,453500,800000041725,NIAGARA UNIVERSITY,2941,2931,10,367,336,31,0,0,607,358,3548,725,670,18,4273,3813.53
2011,40,NIAGARA,2,INDEPENDENT,1,PRIVATE,1,4-Year/Grad,453500,800000041725,NIAGARA UNIVERSITY,2894,2882,12,409,364,45,0,0,548,331,3442,740,631,25,4182,3710.73
2012,40,NIAGARA,2,INDEPENDENT,1,PRIVATE,1,4-Year/Grad,453500,800000041725,NIAGARA UNIVERSITY,2810,2799,11,1542,339,1203,0,0,544,344,3354,1886,641,12,5240,4005.6
2013,40,NIAGARA,2,INDEPENDENT,1,PRIVATE,1,4-Year/Grad,453500,800000041725,NIAGARA UNIVERSITY,2863,2853,10,1582,317,1265,0,0,477,417,3340,1999,698,27,5339,4034.13
2014,40,NIAGARA,2,INDEPENDENT,1,PRIVATE,1,4-Year/Grad,453500,800000041725,NIAGARA UNIVERSITY,2837,2818,19,1597,312,1285,0,0,452,445,3289,2042,616,24,5331,3999.33
2015,40,NIAGARA,2,INDEPENDENT,1,PRIVATE,1,4-Year/Grad,453500,800000041725,NIAGARA UNIVERSITY,2869,2830,39,1756,303,1453,0,0,508,453,3377,2209,642,32,5586,4143.53
2016,40,NIAGARA,2,INDEPENDENT,1,PRIVATE,1,4-Year/Grad,453500,800000041725,NIAGARA UNIVERSITY,2955,2913,42,1508,132,1376,0,0,450,431,3405,1939,622,34,5344,4080.07
2017,40,NIAGARA,2,INDEPENDENT,1,PRIVATE,1,4-Year/Grad,453500,800000041725,NIAGARA UNIVERSITY,2863,2783,80,1441,119,1322,0,0,477,478,3340,1919,590,34,5259,4011.53
2018,40,NIAGARA,2,INDEPENDENT,1,PRIVATE,1,4-Year/Grad,453500,800000041725,NIAGARA UNIVERSITY,2675,2633,42,1470,117,1353,0,0,510,437,3185,1907,513,20,5092,3849.8
2019,40,NIAGARA,2,INDEPENDENT,1,PRIVATE,1,4-Year/Grad,453500,800000041725,NIAGARA UNIVERSITY,2723,2649,74,1455,99,1356,0,0,512,406,3235,1861,626,12,5096,3882.4
2010,26,MONROE,2,INDEPENDENT,1,PRIVATE,1,4-Year/Grad,454000,800000065217,NORTHEASTER SEMINARY AT ROBERTS WESLEYAN COLLEGE,0,0,0,0,0,0,64,26,27,6,91,32,0,0,123,103.8
2011,26,MONROE,2,INDEPENDENT,1,PRIVATE,1,4-Year/Grad,454000,800000065217,NORTHEASTER SEMINARY AT ROBERTS WESLEYAN COLLEGE,0,0,0,0,0,0,92,9,32,13,124,22,0,0,146,132.8
2012,26,MONROE,2,INDEPENDENT,1,PRIVATE,1,4-Year/Grad,454000,800000065217,NORTHEASTER SEMINARY AT ROBERTS WESLEYAN COLLEGE,0,0,0,0,0,0,95,16,41,21,136,37,0,0,173,150.8
2013,26,MONROE,2,INDEPENDENT,1,PRIVATE,1,4-Year/Grad,454000,800000065217,NORTHEASTER SEMINARY AT ROBERTS WESLEYAN COLLEGE,0,0,0,0,0,0,75,34,38,23,113,57,0,0,170,135.8
2014,26,MONROE,2,INDEPENDENT,1,PRIVATE,1,4-Year/Grad,454000,800000065217,NORTHEASTER SEMINARY AT ROBERTS WESLEYAN COLLEGE,0,0,0,0,0,0,71,19,46,18,117,37,0,0,154,131.8
2015,26,MONROE,2,INDEPENDENT,1,PRIVATE,1,4-Year/Grad,454000,800000065217,NORTHEASTER SEMINARY AT ROBERTS WESLEYAN COLLEGE,0,0,0,0,0,0,65,32,31,20,96,52,0,0,148,116.8
2016,26,MONROE,2,INDEPENDENT,1,PRIVATE,1,4-Year/Grad,454000,800000065217,NORTHEASTER SEMINARY AT ROBERTS WESLEYAN COLLEGE,0,0,0,0,0,0,56,31,25,14,81,45,0,0,126,99
2017,26,MONROE,2,INDEPENDENT,1,PRIVATE,1,4-Year/Grad,454000,800000065217,NORTHEASTER SEMINARY AT ROBERTS WESLEYAN COLLEGE,0,0,0,0,0,0,54,27,0,13,54,40,0,0,94,70
2018,26,MONROE,2,INDEPENDENT,1,PRIVATE,1,4-Year/Grad,454000,800000065217,NORTHEASTER SEMINARY AT ROBERTS WESLEYAN COLLEGE,0,0,0,0,0,0,55,32,17,29,72,61,0,0,133,96.4
2019,26,MONROE,2,INDEPENDENT,1,PRIVATE,1,4-Year/Grad,454000,800000065217,NORTHEASTER SEMINARY AT ROBERTS WESLEYAN COLLEGE,0,0,0,0,0,0,50,61,15,37,65,98,0,0,163,104.2
2010,50,ROCKLAND,2,INDEPENDENT,1,PRIVATE,1,4-Year/Grad,454500,800000039179,NYACK COLLEGE,1793,1792,1,298,258,40,208,215,202,368,2203,881,314,11,3084,2535.53
2011,50,ROCKLAND,2,INDEPENDENT,1,PRIVATE,1,4-Year/Grad,454500,800000039179,NYACK COLLEGE,1717,1717,0,285,266,19,195,211,190,484,2102,980,295,8,3082,2475
2012,50,ROCKLAND,2,INDEPENDENT,1,PRIVATE,1,4-Year/Grad,454500,800000039179,NYACK COLLEGE,1678,1676,2,340,295,45,242,149,260,460,2180,949,287,10,3129,2536.93
2013,50,ROCKLAND,2,INDEPENDENT,1,PRIVATE,1,4-Year/Grad,454500,800000039179,NYACK COLLEGE,1510,1508,2,301,290,11,215,182,286,433,2011,916,247,7,2927,2357.33
2014,50,ROCKLAND,2,INDEPENDENT,1,PRIVATE,1,4-Year/Grad,454500,800000039179,NYACK COLLEGE,1402,1402,0,265,255,10,195,173,311,373,1908,811,240,4,2719,2214.73
2015,50,ROCKLAND,2,INDEPENDENT,1,PRIVATE,1,4-Year/Grad,454500,800000039179,NYACK COLLEGE,1284,1284,0,215,210,5,183,144,285,362,1752,721,231,3,2473,2026.07
2016,50,ROCKLAND,2,INDEPENDENT,1,PRIVATE,1,4-Year/Grad,454500,800000039179,NYACK COLLEGE,1152,1151,1,246,235,11,153,117,290,341,1595,704,202,25,2299,1860.2
2017,50,ROCKLAND,2,INDEPENDENT,1,PRIVATE,1,4-Year/Grad,454500,800000039179,NYACK COLLEGE,1119,1119,0,222,211,11,158,108,266,370,1543,700,189,7,2243,1808.2
2018,50,ROCKLAND,2,INDEPENDENT,1,PRIVATE,1,4-Year/Grad,454500,800000039179,NYACK COLLEGE,1081,1081,0,211,201,10,133,108,278,346,1492,665,189,11,2157,1743.93
2019,50,ROCKLAND,2,INDEPENDENT,1,PRIVATE,1,4-Year/Grad,454500,800000039179,NYACK COLLEGE,833,833,0,158,144,14,103,104,276,340,1212,602,117,11,1814,1442.27
2010,31,NEW YORK,2,INDEPENDENT,1,PRIVATE,1,4-Year/Grad,455510,800000047852,PACE UNIVERSITY - NYC CAMPUS,6814,6792,22,1312,812,500,640,214,1062,2710,8516,4236,1784,144,12752,10122.93
2011,31,NEW YORK,2,INDEPENDENT,1,PRIVATE,1,4-Year/Grad,455510,800000047852,PACE UNIVERSITY - NYC CAMPUS,6870,6852,18,1155,768,387,664,155,1087,2662,8621,3972,1581,84,12593,10132.8
2012,31,NEW YORK,2,INDEPENDENT,1,PRIVATE,1,4-Year/Grad,455510,800000047852,PACE UNIVERSITY - NYC CAMPUS,7107,7069,38,1229,814,415,600,131,1059,2646,8766,4006,1812,87,12772,10286.47
2013,31,NEW YORK,2,INDEPENDENT,1,PRIVATE,1,4-Year/Grad,455510,800000047852,PACE UNIVERSITY - NYC CAMPUS,7116,7079,37,1173,804,369,488,102,1544,2201,9148,3476,1758,88,12624,10460.2
2014,31,NEW YORK,2,INDEPENDENT,1,PRIVATE,1,4-Year/Grad,455510,800000047852,PACE UNIVERSITY - NYC CAMPUS,7262,7219,43,1432,944,488,525,25,1494,2119,9281,3576,1938,239,12857,10615.93
2015,31,NEW YORK,2,INDEPENDENT,1,PRIVATE,1,4-Year/Grad,455510,800000047852,PACE UNIVERSITY - NYC CAMPUS,7579,7530,49,1168,841,327,531,32,1613,1920,9723,3120,2052,76,12843,10893.13
2016,31,NEW YORK,2,INDEPENDENT,1,PRIVATE,1,4-Year/Grad,455510,800000047852,PACE UNIVERSITY - NYC CAMPUS,5505,5469,36,779,447,332,0,22,1503,1340,7008,2141,1406,54,9149,7812.47
2017,31,NEW YORK,2,INDEPENDENT,1,PRIVATE,1,4-Year/Grad,455510,800000047852,PACE UNIVERSITY - NYC CAMPUS,5538,5497,41,542,418,124,0,29,1465,1340,7003,1911,1428,43,8914,7731.27
2018,31,NEW YORK,2,INDEPENDENT,1,PRIVATE,1,4-Year/Grad,455510,800000047852,PACE UNIVERSITY - NYC CAMPUS,5519,5470,49,528,379,149,0,40,1391,1696,6910,2264,1373,35,9174,7780.4
2019,31,NEW YORK,2,INDEPENDENT,1,PRIVATE,1,4-Year/Grad,455510,800000047852,PACE UNIVERSITY - NYC CAMPUS,5484,5441,43,440,314,126,0,25,1416,1624,6900,2089,1396,32,8989,7706.27
2016,66,WESTCHESTER,2,INDEPENDENT,1,PRIVATE,1,4-Year/Grad,455520,800000035258,PACE UNIVERSITY PLEASANTVILLE,2186,2185,1,444,283,161,0,0,282,601,2468,1045,567,4,3513,2856.4
2017,66,WESTCHESTER,2,INDEPENDENT,1,PRIVATE,1,4-Year/Grad,455520,800000035258,PACE UNIVERSITY PLEASANTVILLE,2340,2338,2,254,203,51,0,0,274,601,2614,855,571,3,3469,2939.07
2018,66,WESTCHESTER,2,INDEPENDENT,1,PRIVATE,1,4-Year/Grad,455520,800000035258,PACE UNIVERSITY PLEASANTVILLE,2424,2423,1,206,167,39,0,0,330,557,2754,763,603,5,3517,3045.47
2019,66,WESTCHESTER,2,INDEPENDENT,1,PRIVATE,1,4-Year/Grad,455520,800000035258,PACE UNIVERSITY PLEASANTVILLE,2353,2353,0,250,125,125,0,13,451,640,2804,903,521,1,3707,3148.53
2016,66,WESTCHESTER,2,INDEPENDENT,1,PRIVATE,1,4-Year/Grad,455530,800000034815,PACE UNIVERSITY COLLEGE AT WHITE PLAINS,0,0,0,0,0,0,561,22,0,0,561,22,0,0,583,569.8
2017,66,WESTCHESTER,2,INDEPENDENT,1,PRIVATE,1,4-Year/Grad,455530,800000034815,PACE UNIVERSITY COLLEGE AT WHITE PLAINS,0,0,0,0,0,0,577,26,0,0,577,26,0,0,603,587.4
2018,66,WESTCHESTER,2,INDEPENDENT,1,PRIVATE,1,4-Year/Grad,455530,800000034815,PACE UNIVERSITY COLLEGE AT WHITE PLAINS,0,0,0,0,0,0,616,9,7,3,623,12,0,0,635,627.8
2019,66,WESTCHESTER,2,INDEPENDENT,1,PRIVATE,1,4-Year/Grad,455530,800000034815,PACE UNIVERSITY COLLEGE AT WHITE PLAINS,0,0,0,1,0,1,672,26,0,0,672,27,0,0,699,682.73
2010,16,FRANKLIN,2,INDEPENDENT,1,PRIVATE,1,4-Year/Grad,457500,800000051772,PAUL SMITHS COLLEGE,983,983,0,24,22,2,0,0,0,0,983,24,342,0,1007,991
2011,16,FRANKLIN,2,INDEPENDENT,1,PRIVATE,1,4-Year/Grad,457500,800000051772,PAUL SMITHS COLLEGE,1032,1032,0,31,28,3,0,0,0,0,1032,31,326,0,1063,1042.33
2012,16,FRANKLIN,2,INDEPENDENT,1,PRIVATE,1,4-Year/Grad,457500,800000051772,PAUL SMITHS COLLEGE,1053,1053,0,329,13,316,0,0,0,0,1053,329,286,0,1382,1162.67
2013,16,FRANKLIN,2,INDEPENDENT,1,PRIVATE,1,4-Year/Grad,457500,800000051772,PAUL SMITHS COLLEGE,969,969,0,359,9,350,0,0,0,0,969,359,240,0,1328,1088.67
2014,16,FRANKLIN,2,INDEPENDENT,1,PRIVATE,1,4-Year/Grad,457500,800000051772,PAUL SMITHS COLLEGE,881,881,0,250,10,240,0,0,0,0,881,250,244,0,1131,964.33
2015,16,FRANKLIN,2,INDEPENDENT,1,PRIVATE,1,4-Year/Grad,457500,800000051772,PAUL SMITHS COLLEGE,871,871,0,393,15,378,0,0,0,0,871,393,247,0,1264,1002
2016,16,FRANKLIN,2,INDEPENDENT,1,PRIVATE,1,4-Year/Grad,457500,800000051772,PAUL SMITHS COLLEGE,843,842,1,319,9,310,0,0,0,0,843,319,230,0,1162,949.33
2017,16,FRANKLIN,2,INDEPENDENT,1,PRIVATE,1,4-Year/Grad,457500,800000051772,PAUL SMITHS COLLEGE,760,759,1,314,7,307,0,0,0,0,760,314,195,0,1074,864.67
2018,16,FRANKLIN,2,INDEPENDENT,1,PRIVATE,1,4-Year/Grad,457500,800000051772,PAUL SMITHS COLLEGE,731,730,1,14,9,5,0,0,0,0,731,14,186,0,745,735.67
2019,16,FRANKLIN,2,INDEPENDENT,1,PRIVATE,1,4-Year/Grad,457500,800000051772,PAUL SMITHS COLLEGE,703,703,0,13,9,4,0,0,0,0,703,13,185,0,716,707.33
2010,28,NASSAU,2,INDEPENDENT,1,PRIVATE,1,4-Year/Grad,457700,800000049072,THE ELMEZZI GRADUATE SCHOOL OF MOLECULAR MEDICINE,0,0,0,0,0,0,0,0,12,0,12,0,0,0,12,12
2011,28,NASSAU,2,INDEPENDENT,1,PRIVATE,1,4-Year/Grad,457700,800000049072,THE ELMEZZI GRADUATE SCHOOL OF MOLECULAR MEDICINE,0,0,0,0,0,0,0,0,12,0,12,0,0,0,12,12
2012,28,NASSAU,2,INDEPENDENT,1,PRIVATE,1,4-Year/Grad,457700,800000049072,THE ELMEZZI GRADUATE SCHOOL OF MOLECULAR MEDICINE,0,0,0,0,0,0,0,0,11,0,11,0,0,0,11,11
2013,28,NASSAU,2,INDEPENDENT,1,PRIVATE,1,4-Year/Grad,457700,800000049072,THE ELMEZZI GRADUATE SCHOOL OF MOLECULAR MEDICINE,0,0,0,0,0,0,0,0,12,0,12,0,0,0,12,12
2014,28,NASSAU,2,INDEPENDENT,1,PRIVATE,1,4-Year/Grad,457700,800000049072,THE ELMEZZI GRADUATE SCHOOL OF MOLECULAR MEDICINE,0,0,0,0,0,0,0,0,8,0,8,0,0,0,8,8
2015,28,NASSAU,2,INDEPENDENT,1,PRIVATE,1,4-Year/Grad,457700,800000049072,THE ELMEZZI GRADUATE SCHOOL OF MOLECULAR MEDICINE,0,0,0,0,0,0,0,0,8,0,8,0,0,0,8,8
2010,33,KINGS,2,INDEPENDENT,1,PRIVATE,1,4-Year/Grad,458000,800000045458,POLYTECHNIC INSTITUTE OF NY - MAIN CAMPUS,1695,1550,145,73,66,7,0,0,1582,1082,3277,1155,447,0,4432,3734.13
2011,33,KINGS,2,INDEPENDENT,1,PRIVATE,1,4-Year/Grad,458000,800000045458,POLYTECHNIC INSTITUTE OF NY - MAIN CAMPUS,1832,1829,3,107,71,36,0,0,1481,1067,3313,1174,549,27,4487,3775.47
2012,33,KINGS,2,INDEPENDENT,1,PRIVATE,1,4-Year/Grad,458000,800000045458,POLYTECHNIC INSTITUTE OF NY - MAIN CAMPUS,1952,1927,25,119,73,46,0,0,1584,997,3536,1116,520,35,4652,3974.47
2013,33,KINGS,2,INDEPENDENT,1,PRIVATE,1,4-Year/Grad,458000,800000045458,POLYTECHNIC INSTITUTE OF NY - MAIN CAMPUS,2033,2007,26,122,71,51,0,0,1975,760,4008,882,477,42,4890,4352.67
2010,03,BROOME,2,INDEPENDENT,1,PRIVATE,1,4-Year/Grad,458300,800000054887,DAVIS COLLEGE,187,186,1,123,18,105,0,0,0,0,187,123,27,14,310,228
2011,03,BROOME,2,INDEPENDENT,1,PRIVATE,1,4-Year/Grad,458300,800000054887,DAVIS COLLEGE,181,180,1,114,12,102,0,0,0,0,181,114,33,0,295,219
2012,03,BROOME,2,INDEPENDENT,1,PRIVATE,1,4-Year/Grad,458300,800000054887,DAVIS COLLEGE,192,188,4,159,29,130,0,0,0,0,192,159,41,3,351,245
2013,03,BROOME,2,INDEPENDENT,1,PRIVATE,1,4-Year/Grad,458300,800000054887,DAVIS COLLEGE,231,214,17,165,35,130,0,0,0,0,231,165,38,14,396,286
2014,03,BROOME,2,INDEPENDENT,1,PRIVATE,1,4-Year/Grad,458300,800000054887,DAVIS COLLEGE,218,205,13,178,47,131,0,0,0,0,218,178,48,4,396,277.33
2015,03,BROOME,2,INDEPENDENT,1,PRIVATE,1,4-Year/Grad,458300,800000054887,DAVIS COLLEGE,209,178,31,181,53,128,0,0,0,0,209,181,32,8,390,269.33
2016,03,BROOME,2,INDEPENDENT,1,PRIVATE,1,4-Year/Grad,458300,800000054887,DAVIS COLLEGE,184,165,19,151,48,103,0,0,0,0,184,151,35,10,335,234.33
2017,03,BROOME,2,INDEPENDENT,1,PRIVATE,1,4-Year/Grad,458300,800000054887,DAVIS COLLEGE,158,140,18,130,41,89,0,0,0,0,158,130,18,8,288,201.33
2018,03,BROOME,2,INDEPENDENT,1,PRIVATE,1,4-Year/Grad,458300,800000054887,DAVIS COLLEGE,125,113,12,116,26,90,0,0,0,0,125,116,16,10,241,163.67
2019,03,BROOME,2,INDEPENDENT,1,PRIVATE,1,4-Year/Grad,458300,800000054887,DAVIS COLLEGE,35,32,3,50,22,28,0,0,0,0,35,50,0,0,85,51.67
2010,33,KINGS,2,INDEPENDENT,1,PRIVATE,1,4-Year/Grad,458500,800000045459,PRATT INSTITUTE,2845,2820,25,163,160,3,0,0,1456,269,4301,432,725,4,4733,4462.93
2011,33,KINGS,2,INDEPENDENT,1,PRIVATE,1,4-Year/Grad,458500,800000045459,PRATT INSTITUTE,2873,2855,18,148,141,7,0,0,1391,310,4264,458,647,3,4722,4437.33
2012,33,KINGS,2,INDEPENDENT,1,PRIVATE,1,4-Year/Grad,458500,800000045459,PRATT INSTITUTE,3133,3092,41,133,115,18,0,0,1397,218,4530,351,745,3,4881,4661.53
2013,33,KINGS,2,INDEPENDENT,1,PRIVATE,1,4-Year/Grad,458500,800000045459,PRATT INSTITUTE,3202,3145,57,109,102,7,0,0,1312,170,4514,279,736,8,4793,4618.33
2014,33,KINGS,2,INDEPENDENT,1,PRIVATE,1,4-Year/Grad,458500,800000045459,PRATT INSTITUTE,3144,3127,17,135,105,30,0,0,1261,150,4405,285,744,8,4690,4510
2015,33,KINGS,2,INDEPENDENT,1,PRIVATE,1,4-Year/Grad,458500,800000045459,PRATT INSTITUTE,3270,3256,14,123,100,23,0,0,1273,118,4543,241,847,4,4784,4631.2
2016,33,KINGS,2,INDEPENDENT,1,PRIVATE,1,4-Year/Grad,458500,800000045459,PRATT INSTITUTE,3253,3239,14,113,88,25,0,0,963,32,4216,145,817,5,4361,4266.47
2017,33,KINGS,2,INDEPENDENT,1,PRIVATE,1,4-Year/Grad,458500,800000045459,PRATT INSTITUTE,3410,3391,19,103,79,24,0,0,848,162,4258,265,817,9,4523,4357.13
2018,33,KINGS,2,INDEPENDENT,1,PRIVATE,1,4-Year/Grad,458500,800000045459,PRATT INSTITUTE,3434,3413,21,94,73,21,0,0,881,145,4315,239,839,5,4554,4404.33
2019,33,KINGS,2,INDEPENDENT,1,PRIVATE,1,4-Year/Grad,458500,800000045459,PRATT INSTITUTE,3431,3409,22,93,76,17,0,0,824,107,4255,200,865,7,4455,4328.8
2016,31,NEW YORK,2,INDEPENDENT,1,PRIVATE,1,4-Year/Grad,458510,800000057578,PRATT INSTITUTE MANHATTAN CENTER,114,114,0,4,4,0,0,0,285,70,399,74,41,1,473,428.33
2017,31,NEW YORK,2,INDEPENDENT,1,PRIVATE,1,4-Year/Grad,458510,800000057578,PRATT INSTITUTE MANHATTAN CENTER,127,127,0,5,5,0,0,0,317,63,444,68,36,0,512,470.87
2018,31,NEW YORK,2,INDEPENDENT,1,PRIVATE,1,4-Year/Grad,458510,800000057578,PRATT INSTITUTE MANHATTAN CENTER,102,102,0,4,3,1,0,0,313,42,415,46,28,0,461,433.13
2019,31,NEW YORK,2,INDEPENDENT,1,PRIVATE,1,4-Year/Grad,458510,800000057578,PRATT INSTITUTE MANHATTAN CENTER,147,147,0,14,13,1,0,0,389,74,536,88,57,2,624,570.27
2010,31,NEW YORK,2,INDEPENDENT,1,PRIVATE,0,2-Year,458700,800000065221,PROFESSIONAL BUSINESS COLLEGE,733,733,0,11,11,0,0,0,0,0,733,11,358,0,744,736.67
2011,31,NEW YORK,2,INDEPENDENT,1,PRIVATE,0,2-Year,458700,800000065221,PROFESSIONAL BUSINESS COLLEGE,844,844,0,3,3,0,0,0,0,0,844,3,444,0,847,845
2012,31,NEW YORK,2,INDEPENDENT,1,PRIVATE,0,2-Year,458700,800000065221,PROFESSIONAL BUSINESS COLLEGE,1090,1090,0,0,0,0,0,0,0,0,1090,0,487,0,1090,1090
2013,31,NEW YORK,2,INDEPENDENT,1,PRIVATE,0,2-Year,458700,800000065221,PROFESSIONAL BUSINESS COLLEGE,875,875,0,9,9,0,0,0,0,0,875,9,239,1,884,878
2014,31,NEW YORK,2,INDEPENDENT,1,PRIVATE,0,2-Year,458700,800000065221,PROFESSIONAL BUSINESS COLLEGE,313,313,0,1,1,0,0,0,0,0,313,1,0,0,314,313.33
2010,31,NEW YORK,2,INDEPENDENT,1,PRIVATE,1,4-Year/Grad,459000,800000046928,RABBI ISAAC ELCHANAN THEO SEMINARY,0,0,0,0,0,0,285,59,0,34,285,93,0,0,378,322.2
2011,31,NEW YORK,2,INDEPENDENT,1,PRIVATE,1,4-Year/Grad,459000,800000046928,RABBI ISAAC ELCHANAN THEO SEMINARY,0,0,0,0,0,0,237,34,0,69,237,103,0,0,340,278.2
2012,31,NEW YORK,2,INDEPENDENT,1,PRIVATE,1,4-Year/Grad,459000,800000046928,RABBI ISAAC ELCHANAN THEO SEMINARY,0,0,0,0,0,0,259,18,0,46,259,64,0,0,323,284.6
2013,31,NEW YORK,2,INDEPENDENT,1,PRIVATE,1,4-Year/Grad,459000,800000046928,RABBI ISAAC ELCHANAN THEO SEMINARY,0,0,0,0,0,0,255,16,0,52,255,68,0,0,323,282.2
2014,31,NEW YORK,2,INDEPENDENT,1,PRIVATE,1,4-Year/Grad,459000,800000046928,RABBI ISAAC ELCHANAN THEO SEMINARY,0,0,0,0,0,0,138,6,0,1,138,7,0,0,145,140.8
2015,31,NEW YORK,2,INDEPENDENT,1,PRIVATE,1,4-Year/Grad,459000,800000046928,RABBI ISAAC ELCHANAN THEO SEMINARY,0,0,0,0,0,0,201,7,0,34,201,41,0,0,242,217.4
2016,31,NEW YORK,2,INDEPENDENT,1,PRIVATE,1,4-Year/Grad,459000,800000046928,RABBI ISAAC ELCHANAN THEO SEMINARY,0,0,0,0,0,0,210,16,0,30,210,46,0,0,256,228.4
2017,31,NEW YORK,2,INDEPENDENT,1,PRIVATE,1,4-Year/Grad,459000,800000046928,RABBI ISAAC ELCHANAN THEO SEMINARY,0,0,0,0,0,0,193,26,0,48,193,74,0,0,267,222.6
2019,31,NEW YORK,2,INDEPENDENT,1,PRIVATE,1,4-Year/Grad,459000,800000046928,RABBI ISAAC ELCHANAN THEO SEMINARY,0,0,0,0,0,0,159,11,0,42,159,53,0,0,212,180.2
2010,01,ALBANY,2,INDEPENDENT,1,PRIVATE,1,4-Year/Grad,459200,800000055584,EXCELSIOR COLLEGE,0,0,0,5740,5496,244,0,0,0,708,0,6448,0,0,6448,2196.53
2011,01,ALBANY,2,INDEPENDENT,1,PRIVATE,1,4-Year/Grad,459200,800000055584,EXCELSIOR COLLEGE,0,0,0,5754,5450,304,0,0,0,1016,0,6770,0,0,6770,2324.4
2012,01,ALBANY,2,INDEPENDENT,1,PRIVATE,1,4-Year/Grad,459200,800000055584,EXCELSIOR COLLEGE,0,0,0,5717,5493,224,0,0,0,950,0,6667,0,0,6667,2285.67
2013,01,ALBANY,2,INDEPENDENT,1,PRIVATE,1,4-Year/Grad,459200,800000055584,EXCELSIOR COLLEGE,0,0,0,7653,7653,0,0,0,0,1097,0,8750,0,0,8750,2989.8
2014,01,ALBANY,2,INDEPENDENT,1,PRIVATE,1,4-Year/Grad,459200,800000055584,EXCELSIOR COLLEGE,0,0,0,9215,9215,0,0,0,0,1055,0,10270,0,0,10270,3493.67
2015,01,ALBANY,2,INDEPENDENT,1,PRIVATE,1,4-Year/Grad,459200,800000055584,EXCELSIOR COLLEGE,0,0,0,11297,11297,0,0,0,0,1391,0,12688,0,0,12688,4322.07
2016,01,ALBANY,2,INDEPENDENT,1,PRIVATE,1,4-Year/Grad,459200,800000055584,EXCELSIOR COLLEGE,0,0,0,11785,11785,0,0,0,0,1527,0,13312,0,0,13312,4539.13
2017,01,ALBANY,2,INDEPENDENT,1,PRIVATE,1,4-Year/Grad,459200,800000055584,EXCELSIOR COLLEGE,0,0,0,9266,9266,0,0,0,0,1387,0,10653,0,0,10653,3643.47
2018,01,ALBANY,2,INDEPENDENT,1,PRIVATE,1,4-Year/Grad,459200,800000055584,EXCELSIOR COLLEGE,0,0,0,9996,9996,0,0,0,0,1487,0,11483,0,0,11483,3926.8
2019,01,ALBANY,2,INDEPENDENT,1,PRIVATE,1,4-Year/Grad,459200,800000055584,EXCELSIOR COLLEGE,0,0,0,8856,8856,0,0,0,0,1445,0,10301,0,0,10301,3530
2011,31,NEW YORK,2,INDEPENDENT,1,PRIVATE,1,4-Year/Grad,459300,800000070595,RELAY SCHOOL OF EDUCATION,0,0,0,0,0,0,0,0,0,221,0,221,0,0,221,88.4
2012,31,NEW YORK,2,INDEPENDENT,1,PRIVATE,1,4-Year/Grad,459300,800000070595,RELAY SCHOOL OF EDUCATION,0,0,0,0,0,0,0,0,0,387,0,387,0,0,387,154.8
2013,31,NEW YORK,2,INDEPENDENT,1,PRIVATE,1,4-Year/Grad,459300,800000070595,RELAY SCHOOL OF EDUCATION,0,0,0,0,0,0,0,0,0,721,0,721,0,0,721,288.4
2015,31,NEW YORK,2,INDEPENDENT,1,PRIVATE,1,4-Year/Grad,459300,800000070595,RELAY SCHOOL OF EDUCATION,0,0,0,0,0,0,0,0,0,934,0,934,0,0,934,373.6
2017,31,NEW YORK,2,INDEPENDENT,1,PRIVATE,1,4-Year/Grad,459300,800000070595,RELAY SCHOOL OF EDUCATION,0,0,0,0,0,0,0,0,0,1382,0,1382,0,0,1382,552.8
2018,31,NEW YORK,2,INDEPENDENT,1,PRIVATE,1,4-Year/Grad,459300,800000070595,RELAY SCHOOL OF EDUCATION,0,0,0,0,0,0,0,0,0,1641,0,1641,0,0,1641,656.4
2019,31,NEW YORK,2,INDEPENDENT,1,PRIVATE,1,4-Year/Grad,459300,800000070595,RELAY SCHOOL OF EDUCATION,0,0,0,0,0,0,0,0,0,1632,0,1632,0,0,1632,652.8
2010,49,RENSSELAER,2,INDEPENDENT,1,PRIVATE,1,4-Year/Grad,459500,800000039427,RENSSELAER POLYTECH INSTITUTE,5407,5346,61,24,2,22,0,0,1091,183,6498,207,1154,0,6705,6579.2
2011,49,RENSSELAER,2,INDEPENDENT,1,PRIVATE,1,4-Year/Grad,459500,800000039427,RENSSELAER POLYTECH INSTITUTE,5298,5238,60,23,2,21,0,0,1094,123,6392,146,1186,0,6538,6448.87
2012,49,RENSSELAER,2,INDEPENDENT,1,PRIVATE,1,4-Year/Grad,459500,800000039427,RENSSELAER POLYTECH INSTITUTE,5371,5298,73,20,2,18,0,0,1167,100,6538,120,1326,0,6658,6584.67
2013,49,RENSSELAER,2,INDEPENDENT,1,PRIVATE,1,4-Year/Grad,459500,800000039427,RENSSELAER POLYTECH INSTITUTE,5435,5377,58,17,2,15,0,0,1138,124,6573,141,1411,0,6714,6628.27
2014,49,RENSSELAER,2,INDEPENDENT,1,PRIVATE,1,4-Year/Grad,459500,800000039427,RENSSELAER POLYTECH INSTITUTE,5598,5556,42,20,1,19,0,0,1073,144,6671,164,1331,0,6835,6735.27
2017,49,RENSSELAER,2,INDEPENDENT,1,PRIVATE,1,4-Year/Grad,459500,800000039427,RENSSELAER POLYTECH INSTITUTE,6340,6305,35,26,9,17,0,0,1123,103,7463,129,1663,0,7592,7512.87
2010,26,MONROE,2,INDEPENDENT,1,PRIVATE,1,4-Year/Grad,460000,800000050585,ROBERTS WESLEYAN COLLEGE,1225,1222,3,121,110,11,0,0,353,136,1578,257,203,1,1835,1672.73
2011,26,MONROE,2,INDEPENDENT,1,PRIVATE,1,4-Year/Grad,460000,800000050585,ROBERTS WESLEYAN COLLEGE,1233,1232,1,144,125,19,0,0,351,95,1584,239,236,2,1823,1670
2012,26,MONROE,2,INDEPENDENT,1,PRIVATE,1,4-Year/Grad,460000,800000050585,ROBERTS WESLEYAN COLLEGE,1177,1177,0,146,111,35,0,0,350,79,1527,225,210,3,1752,1607.27
2013,26,MONROE,2,INDEPENDENT,1,PRIVATE,1,4-Year/Grad,460000,800000050585,ROBERTS WESLEYAN COLLEGE,1225,1223,2,90,79,11,0,0,360,60,1585,150,203,3,1735,1639
2014,26,MONROE,2,INDEPENDENT,1,PRIVATE,1,4-Year/Grad,460000,800000050585,ROBERTS WESLEYAN COLLEGE,1220,1219,1,116,77,39,0,0,358,68,1578,184,255,1,1762,1643.87
2015,26,MONROE,2,INDEPENDENT,1,PRIVATE,1,4-Year/Grad,460000,800000050585,ROBERTS WESLEYAN COLLEGE,1215,1215,0,109,67,42,0,0,316,72,1531,181,236,2,1712,1596.13
2016,26,MONROE,2,INDEPENDENT,1,PRIVATE,1,4-Year/Grad,460000,800000050585,ROBERTS WESLEYAN COLLEGE,1207,1207,0,109,59,50,0,0,328,54,1535,163,226,1,1698,1592.93
2017,26,MONROE,2,INDEPENDENT,1,PRIVATE,1,4-Year/Grad,460000,800000050585,ROBERTS WESLEYAN COLLEGE,1248,1248,0,73,49,24,0,0,362,57,1610,130,219,2,1740,1657.13
2018,26,MONROE,2,INDEPENDENT,1,PRIVATE,1,4-Year/Grad,460000,800000050585,ROBERTS WESLEYAN COLLEGE,1201,1201,0,134,128,6,18,0,322,64,1541,198,228,0,1739,1611.27
2019,26,MONROE,2,INDEPENDENT,1,PRIVATE,1,4-Year/Grad,460000,800000050585,ROBERTS WESLEYAN COLLEGE,1176,1176,0,100,77,23,32,9,371,75,1579,184,220,2,1763,1645.93
2010,26,MONROE,2,INDEPENDENT,1,PRIVATE,1,4-Year/Grad,460500,800000050298,ROCHESTER INSTITUTE OF TECHNOLOGY,11990,11970,20,1133,698,435,0,0,1546,835,13536,1968,2601,224,15504,14247.67
2011,26,MONROE,2,INDEPENDENT,1,PRIVATE,1,4-Year/Grad,460500,800000050298,ROCHESTER INSTITUTE OF TECHNOLOGY,12333,12309,24,1216,706,510,0,0,1841,776,14174,1992,2679,104,16166,14889.73
2012,26,MONROE,2,INDEPENDENT,1,PRIVATE,1,4-Year/Grad,460500,800000050298,ROCHESTER INSTITUTE OF TECHNOLOGY,12393,12373,20,1318,578,740,0,0,1907,739,14300,2057,2726,93,16357,15034.93
2013,26,MONROE,2,INDEPENDENT,1,PRIVATE,1,4-Year/Grad,460500,800000050298,ROCHESTER INSTITUTE OF TECHNOLOGY,12106,12084,22,1774,503,1271,0,0,2021,690,14127,2464,2770,67,16591,14994.33
2014,26,MONROE,2,INDEPENDENT,1,PRIVATE,1,4-Year/Grad,460500,800000050298,ROCHESTER INSTITUTE OF TECHNOLOGY,12211,12191,20,1249,444,805,0,0,2220,640,14431,1889,2690,62,16320,15103.33
2015,26,MONROE,2,INDEPENDENT,1,PRIVATE,1,4-Year/Grad,460500,800000050298,ROCHESTER INSTITUTE OF TECHNOLOGY,12471,12453,18,1071,420,651,0,0,2474,623,14945,1694,2918,66,16639,15551.2
2016,26,MONROE,2,INDEPENDENT,1,PRIVATE,1,4-Year/Grad,460500,800000050298,ROCHESTER INSTITUTE OF TECHNOLOGY,12253,12231,22,1131,407,724,0,0,2536,587,14789,1718,2612,53,16507,15400.8
2017,26,MONROE,2,INDEPENDENT,1,PRIVATE,1,4-Year/Grad,460500,800000050298,ROCHESTER INSTITUTE OF TECHNOLOGY,12447,12435,12,1068,423,645,0,0,2472,597,14919,1665,2765,73,16584,15513.8
2018,26,MONROE,2,INDEPENDENT,1,PRIVATE,1,4-Year/Grad,460500,800000050298,ROCHESTER INSTITUTE OF TECHNOLOGY,12486,12473,13,1027,413,614,0,0,2381,569,14867,1596,2853,55,16463,15436.93
2019,26,MONROE,2,INDEPENDENT,1,PRIVATE,1,4-Year/Grad,460500,800000050298,ROCHESTER INSTITUTE OF TECHNOLOGY,12254,12230,24,1059,393,666,0,0,2339,602,14593,1661,2701,54,16254,15186.8
2010,31,NEW YORK,2,INDEPENDENT,1,PRIVATE,1,4-Year/Grad,461000,800000047843,ROCKEFELLER UNIVERSITY,0,0,0,0,0,0,0,0,193,0,193,0,0,0,193,193
2011,31,NEW YORK,2,INDEPENDENT,1,PRIVATE,1,4-Year/Grad,461000,800000047843,ROCKEFELLER UNIVERSITY,0,0,0,0,0,0,0,0,207,0,207,0,0,0,207,207
2012,31,NEW YORK,2,INDEPENDENT,1,PRIVATE,1,4-Year/Grad,461000,800000047843,ROCKEFELLER UNIVERSITY,0,0,0,0,0,0,0,0,192,0,192,0,0,0,192,192
2013,31,NEW YORK,2,INDEPENDENT,1,PRIVATE,1,4-Year/Grad,461000,800000047843,ROCKEFELLER UNIVERSITY,0,0,0,0,0,0,0,0,202,0,202,0,0,0,202,202
2014,31,NEW YORK,2,INDEPENDENT,1,PRIVATE,1,4-Year/Grad,461000,800000047843,ROCKEFELLER UNIVERSITY,0,0,0,0,0,0,0,0,209,0,209,0,0,0,209,209
2015,31,NEW YORK,2,INDEPENDENT,1,PRIVATE,1,4-Year/Grad,461000,800000047843,ROCKEFELLER UNIVERSITY,0,0,0,0,0,0,0,0,209,0,209,0,0,0,209,209
2016,31,NEW YORK,2,INDEPENDENT,1,PRIVATE,1,4-Year/Grad,461000,800000047843,ROCKEFELLER UNIVERSITY,0,0,0,0,0,0,0,0,216,0,216,0,0,0,216,216
2017,31,NEW YORK,2,INDEPENDENT,1,PRIVATE,1,4-Year/Grad,461000,800000047843,ROCKEFELLER UNIVERSITY,0,0,0,0,0,0,0,0,232,0,232,0,0,0,232,232
2018,31,NEW YORK,2,INDEPENDENT,1,PRIVATE,1,4-Year/Grad,461000,800000047843,ROCKEFELLER UNIVERSITY,0,0,0,0,0,0,0,0,239,0,239,0,0,0,239,239
2019,31,NEW YORK,2,INDEPENDENT,1,PRIVATE,1,4-Year/Grad,461000,800000047843,ROCKEFELLER UNIVERSITY,0,0,0,0,0,0,0,0,247,0,247,0,0,0,247,247
2010,49,RENSSELAER,2,INDEPENDENT,1,PRIVATE,1,4-Year/Grad,462000,800000039449,RUSSELL SAGE COLLEGE,697,691,6,44,21,23,0,0,0,0,697,44,122,0,741,711.67
2011,49,RENSSELAER,2,INDEPENDENT,1,PRIVATE,1,4-Year/Grad,462000,800000039449,RUSSELL SAGE COLLEGE,745,741,4,44,22,22,0,0,0,0,745,44,152,1,789,759.67
2012,49,RENSSELAER,2,INDEPENDENT,1,PRIVATE,1,4-Year/Grad,462000,800000039449,RUSSELL SAGE COLLEGE,780,778,2,47,19,28,0,0,0,0,780,47,158,0,827,795.67
2013,49,RENSSELAER,2,INDEPENDENT,1,PRIVATE,1,4-Year/Grad,462000,800000039449,RUSSELL SAGE COLLEGE,782,782,0,41,15,26,0,0,0,0,782,41,158,0,823,795.67
2014,49,RENSSELAER,2,INDEPENDENT,1,PRIVATE,1,4-Year/Grad,462000,800000039449,RUSSELL SAGE COLLEGE,799,793,6,48,19,29,0,0,0,0,799,48,160,0,847,815
2015,49,RENSSELAER,2,INDEPENDENT,1,PRIVATE,1,4-Year/Grad,462000,800000039449,RUSSELL SAGE COLLEGE,778,778,0,48,23,25,0,0,0,0,778,48,147,0,826,794
2016,49,RENSSELAER,2,INDEPENDENT,1,PRIVATE,1,4-Year/Grad,462000,800000039449,RUSSELL SAGE COLLEGE,688,688,0,46,10,36,0,0,0,0,688,46,99,1,734,703.33
2017,49,RENSSELAER,2,INDEPENDENT,1,PRIVATE,1,4-Year/Grad,462000,800000039449,RUSSELL SAGE COLLEGE,604,604,0,40,17,23,0,0,0,0,604,40,90,0,644,617.33
2018,49,RENSSELAER,2,INDEPENDENT,1,PRIVATE,1,4-Year/Grad,462000,800000039449,RUSSELL SAGE COLLEGE,658,658,0,31,8,23,0,0,0,0,658,31,136,0,689,668.33
2019,49,RENSSELAER,2,INDEPENDENT,1,PRIVATE,1,4-Year/Grad,462000,800000039449,RUSSELL SAGE COLLEGE,555,555,0,18,10,8,0,0,0,0,555,18,97,0,573,561
2010,01,ALBANY,2,INDEPENDENT,1,PRIVATE,1,4-Year/Grad,462020,800000057560,RUSSELL SAGE COLLEGE -  ALBANY CAMPUS,612,611,1,306,263,43,107,21,353,826,1072,1153,130,0,2225,1512.8
2011,01,ALBANY,2,INDEPENDENT,1,PRIVATE,1,4-Year/Grad,462020,800000057560,RUSSELL SAGE COLLEGE -  ALBANY CAMPUS,667,667,0,236,208,28,110,19,348,773,1125,1028,154,0,2153,1520.47
2012,01,ALBANY,2,INDEPENDENT,1,PRIVATE,1,4-Year/Grad,462020,800000057560,RUSSELL SAGE COLLEGE -  ALBANY CAMPUS,681,676,5,233,213,20,107,3,377,737,1165,973,126,1,2138,1538.67
2013,01,ALBANY,2,INDEPENDENT,1,PRIVATE,1,4-Year/Grad,462020,800000057560,RUSSELL SAGE COLLEGE -  ALBANY CAMPUS,641,641,0,217,200,17,99,2,307,727,1047,946,137,0,1993,1410.93
2014,01,ALBANY,2,INDEPENDENT,1,PRIVATE,1,4-Year/Grad,462020,800000057560,RUSSELL SAGE COLLEGE -  ALBANY CAMPUS,664,664,0,193,181,12,105,39,364,666,1133,898,123,0,2031,1479.33
2015,01,ALBANY,2,INDEPENDENT,1,PRIVATE,1,4-Year/Grad,462020,800000057560,RUSSELL SAGE COLLEGE -  ALBANY CAMPUS,641,641,0,180,176,4,103,40,402,705,1146,925,115,0,2071,1504
2016,01,ALBANY,2,INDEPENDENT,1,PRIVATE,1,4-Year/Grad,462020,800000057560,RUSSELL SAGE COLLEGE -  ALBANY CAMPUS,590,590,0,149,143,6,102,29,390,719,1082,897,106,0,1979,1430.87
2017,01,ALBANY,2,INDEPENDENT,1,PRIVATE,1,4-Year/Grad,462020,800000057560,RUSSELL SAGE COLLEGE -  ALBANY CAMPUS,555,555,0,124,114,10,98,24,340,743,993,891,111,1,1884,1341.13
2018,01,ALBANY,2,INDEPENDENT,1,PRIVATE,1,4-Year/Grad,462020,800000057560,RUSSELL SAGE COLLEGE -  ALBANY CAMPUS,702,702,0,86,82,4,101,19,325,711,1128,816,233,1,1944,1448.67
2019,01,ALBANY,2,INDEPENDENT,1,PRIVATE,1,4-Year/Grad,462020,800000057560,RUSSELL SAGE COLLEGE -  ALBANY CAMPUS,688,688,0,92,89,3,91,12,331,609,1110,713,137,0,1823,1389.07
2010,26,MONROE,2,INDEPENDENT,1,PRIVATE,1,4-Year/Grad,463000,800000065116,ST. BERNARD'S SCHOOL OF THEOLOGY AND MINISTRY,0,0,0,0,0,0,2,19,5,87,7,106,0,0,113,49.4
2011,26,MONROE,2,INDEPENDENT,1,PRIVATE,1,4-Year/Grad,463000,800000065116,ST. BERNARD'S SCHOOL OF THEOLOGY AND MINISTRY,0,0,0,0,0,0,1,15,4,87,5,102,0,0,107,45.8
2012,26,MONROE,2,INDEPENDENT,1,PRIVATE,1,4-Year/Grad,463000,800000065116,ST. BERNARD'S SCHOOL OF THEOLOGY AND MINISTRY,0,0,0,0,0,0,1,11,4,80,5,91,0,0,96,41.4
2013,26,MONROE,2,INDEPENDENT,1,PRIVATE,1,4-Year/Grad,463000,800000065116,ST. BERNARD'S SCHOOL OF THEOLOGY AND MINISTRY,0,0,0,0,0,0,0,7,2,89,2,96,0,0,98,40.4
2014,26,MONROE,2,INDEPENDENT,1,PRIVATE,1,4-Year/Grad,463000,800000065116,ST. BERNARD'S SCHOOL OF THEOLOGY AND MINISTRY,0,0,0,0,0,0,1,9,4,79,5,88,0,0,93,40.2
2015,26,MONROE,2,INDEPENDENT,1,PRIVATE,1,4-Year/Grad,463000,800000065116,ST. BERNARD'S SCHOOL OF THEOLOGY AND MINISTRY,0,0,0,0,0,0,1,10,2,68,3,78,0,0,81,34.2
2016,26,MONROE,2,INDEPENDENT,1,PRIVATE,1,4-Year/Grad,463000,800000065116,ST. BERNARD'S SCHOOL OF THEOLOGY AND MINISTRY,0,0,0,0,0,0,4,7,9,59,13,66,0,0,79,39.4
2017,26,MONROE,2,INDEPENDENT,1,PRIVATE,1,4-Year/Grad,463000,800000065116,ST. BERNARD'S SCHOOL OF THEOLOGY AND MINISTRY,0,0,0,0,0,0,2,9,3,68,5,77,0,0,82,35.8
2018,26,MONROE,2,INDEPENDENT,1,PRIVATE,1,4-Year/Grad,463000,800000065116,ST. BERNARD'S SCHOOL OF THEOLOGY AND MINISTRY,0,0,0,0,0,0,0,0,4,79,4,79,0,0,83,35.6
2019,26,MONROE,2,INDEPENDENT,1,PRIVATE,1,4-Year/Grad,463000,800000065116,ST. BERNARD'S SCHOOL OF THEOLOGY AND MINISTRY,0,0,0,0,0,0,0,0,9,59,9,59,0,0,68,32.6
2010,04,CATTARAUGUS,2,INDEPENDENT,1,PRIVATE,1,4-Year/Grad,463500,800000054787,ST BONAVENTURE UNIVERSITY,1937,1919,18,59,17,42,0,0,323,195,2260,254,494,0,2514,2357.67
2011,04,CATTARAUGUS,2,INDEPENDENT,1,PRIVATE,1,4-Year/Grad,463500,800000054787,ST BONAVENTURE UNIVERSITY,1890,1873,17,69,21,48,0,0,306,195,2196,264,489,0,2460,2297
2012,04,CATTARAUGUS,2,INDEPENDENT,1,PRIVATE,1,4-Year/Grad,463500,800000054787,ST BONAVENTURE UNIVERSITY,1839,1827,12,69,21,48,0,0,288,133,2127,202,486,0,2329,2203.2
2013,04,CATTARAUGUS,2,INDEPENDENT,1,PRIVATE,1,4-Year/Grad,463500,800000054787,ST BONAVENTURE UNIVERSITY,1780,1767,13,46,20,26,0,0,257,161,2037,207,438,0,2244,2116.73
2014,04,CATTARAUGUS,2,INDEPENDENT,1,PRIVATE,1,4-Year/Grad,463500,800000054787,ST BONAVENTURE UNIVERSITY,1725,1716,9,46,17,29,0,0,227,149,1952,195,435,0,2147,2026.93
2015,04,CATTARAUGUS,2,INDEPENDENT,1,PRIVATE,1,4-Year/Grad,463500,800000054787,ST BONAVENTURE UNIVERSITY,1625,1620,5,49,17,32,0,0,189,129,1814,178,390,0,1992,1881.93
2016,04,CATTARAUGUS,2,INDEPENDENT,1,PRIVATE,1,4-Year/Grad,463500,800000054787,ST BONAVENTURE UNIVERSITY,1591,1588,3,61,24,37,0,0,187,201,1778,262,432,1,2040,1878.73
2017,04,CATTARAUGUS,2,INDEPENDENT,1,PRIVATE,1,4-Year/Grad,463500,800000054787,ST BONAVENTURE UNIVERSITY,1586,1579,7,36,13,23,0,0,186,276,1772,312,439,0,2084,1894.4
2018,04,CATTARAUGUS,2,INDEPENDENT,1,PRIVATE,1,4-Year/Grad,463500,800000054787,ST BONAVENTURE UNIVERSITY,1717,1709,8,97,18,79,0,0,155,399,1872,496,553,0,2368,2063.93
2019,04,CATTARAUGUS,2,INDEPENDENT,1,PRIVATE,1,4-Year/Grad,463500,800000054787,ST BONAVENTURE UNIVERSITY,1767,1765,2,60,22,38,0,0,121,457,1888,517,492,0,2405,2090.8
2010,41,ONEIDA,2,INDEPENDENT,1,PRIVATE,0,2-Year,464000,800000041218,ST ELIZABETH HOSPITAL COLLEGE OF NURSING,160,160,0,80,80,0,0,0,0,0,160,80,17,0,240,186.67
2011,41,ONEIDA,2,INDEPENDENT,1,PRIVATE,0,2-Year,464000,800000041218,ST ELIZABETH HOSPITAL COLLEGE OF NURSING,142,142,0,71,71,0,0,0,0,0,142,71,17,0,213,165.67
2012,41,ONEIDA,2,INDEPENDENT,1,PRIVATE,0,2-Year,464000,800000041218,ST ELIZABETH HOSPITAL COLLEGE OF NURSING,90,90,0,109,109,0,0,0,0,0,90,109,5,1,199,126.33
2013,41,ONEIDA,2,INDEPENDENT,1,PRIVATE,0,2-Year,464000,800000041218,ST ELIZABETH HOSPITAL COLLEGE OF NURSING,72,72,0,89,89,0,0,0,0,0,72,89,3,0,161,101.67
2014,41,ONEIDA,2,INDEPENDENT,1,PRIVATE,0,2-Year,464000,800000041218,ST ELIZABETH HOSPITAL COLLEGE OF NURSING,80,80,0,129,129,0,0,0,0,0,80,129,9,3,209,123
2015,41,ONEIDA,2,INDEPENDENT,1,PRIVATE,0,2-Year,464000,800000041218,ST ELIZABETH HOSPITAL COLLEGE OF NURSING,94,94,0,112,112,0,0,0,0,0,94,112,6,1,206,131.33
2016,41,ONEIDA,2,INDEPENDENT,1,PRIVATE,0,2-Year,464000,800000041218,ST ELIZABETH HOSPITAL COLLEGE OF NURSING,61,61,0,135,135,0,0,0,0,0,61,135,0,0,196,106
2017,41,ONEIDA,2,INDEPENDENT,1,PRIVATE,0,2-Year,464000,800000041218,ST ELIZABETH HOSPITAL COLLEGE OF NURSING,87,87,0,115,115,0,0,0,0,0,87,115,2,0,202,125.33
2018,41,ONEIDA,2,INDEPENDENT,1,PRIVATE,0,2-Year,464000,800000041218,ST ELIZABETH HOSPITAL COLLEGE OF NURSING,101,101,0,96,96,0,0,0,0,0,101,96,0,0,197,133
2019,41,ONEIDA,2,INDEPENDENT,1,PRIVATE,0,2-Year,464000,800000041218,ST ELIZABETH HOSPITAL COLLEGE OF NURSING,93,93,0,89,89,0,0,0,0,0,93,89,0,0,182,122.67
2010,33,KINGS,2,INDEPENDENT,1,PRIVATE,1,4-Year/Grad,464500,800000045455,ST FRANCIS COLLEGE,2310,2306,4,280,256,24,0,0,33,13,2343,293,559,26,2636,2441.53
2011,33,KINGS,2,INDEPENDENT,1,PRIVATE,1,4-Year/Grad,464500,800000045455,ST FRANCIS COLLEGE,2393,2392,1,304,256,48,0,0,31,16,2424,320,454,35,2744,2531.73
2012,33,KINGS,2,INDEPENDENT,1,PRIVATE,1,4-Year/Grad,464500,800000045455,ST FRANCIS COLLEGE,2541,2538,3,296,252,44,0,0,36,30,2577,326,691,5,2903,2687.67
2013,33,KINGS,2,INDEPENDENT,1,PRIVATE,1,4-Year/Grad,464500,800000045455,ST FRANCIS COLLEGE,2456,2454,2,308,271,37,0,0,25,30,2481,338,566,2,2819,2595.67
2014,33,KINGS,2,INDEPENDENT,1,PRIVATE,1,4-Year/Grad,464500,800000045455,ST FRANCIS COLLEGE,2414,2413,1,257,233,24,0,0,39,39,2453,296,510,15,2749,2554.27
2015,33,KINGS,2,INDEPENDENT,1,PRIVATE,1,4-Year/Grad,464500,800000045455,ST FRANCIS COLLEGE,2393,2393,0,205,185,20,0,0,41,33,2434,238,533,11,2672,2515.53
2016,33,KINGS,2,INDEPENDENT,1,PRIVATE,1,4-Year/Grad,464500,800000045455,ST FRANCIS COLLEGE,2343,2339,4,220,200,20,0,0,49,30,2392,250,502,17,2642,2477.33
2017,33,KINGS,2,INDEPENDENT,1,PRIVATE,1,4-Year/Grad,464500,800000045455,ST FRANCIS COLLEGE,2098,2097,1,191,171,20,0,0,50,24,2148,215,437,18,2363,2221.27
2018,33,KINGS,2,INDEPENDENT,1,PRIVATE,1,4-Year/Grad,464500,800000045455,ST FRANCIS COLLEGE,2195,2195,0,128,120,8,0,0,44,46,2239,174,561,6,2413,2300.07
2010,26,MONROE,2,INDEPENDENT,1,PRIVATE,1,4-Year/Grad,465000,800000050296,ST JOHN FISHER COLLEGE,2688,2687,1,200,177,23,297,6,335,494,3320,700,623,0,4020,3586.67
2011,26,MONROE,2,INDEPENDENT,1,PRIVATE,1,4-Year/Grad,465000,800000050296,ST JOHN FISHER COLLEGE,2672,2670,2,199,183,16,314,12,304,476,3290,687,554,1,3977,3551.53
2012,26,MONROE,2,INDEPENDENT,1,PRIVATE,1,4-Year/Grad,465000,800000050296,ST JOHN FISHER COLLEGE,2753,2753,0,207,184,23,328,9,294,417,3375,633,578,0,4008,3614.4
2013,26,MONROE,2,INDEPENDENT,1,PRIVATE,1,4-Year/Grad,465000,800000050296,ST JOHN FISHER COLLEGE,2738,2737,1,221,211,10,333,10,279,406,3350,637,521,0,3987,3590.07
2014,26,MONROE,2,INDEPENDENT,1,PRIVATE,1,4-Year/Grad,465000,800000050296,ST JOHN FISHER COLLEGE,2661,2661,0,196,183,13,334,12,294,359,3289,567,597,0,3856,3502.73
2015,26,MONROE,2,INDEPENDENT,1,PRIVATE,1,4-Year/Grad,465000,800000050296,ST JOHN FISHER COLLEGE,2601,2601,0,186,172,14,346,14,298,360,3245,560,552,1,3805,3456.6
2016,26,MONROE,2,INDEPENDENT,1,PRIVATE,1,4-Year/Grad,465000,800000050296,ST JOHN FISHER COLLEGE,2603,2603,0,179,150,29,341,17,290,353,3234,549,576,0,3783,3441.67
2017,26,MONROE,2,INDEPENDENT,1,PRIVATE,1,4-Year/Grad,465000,800000050296,ST JOHN FISHER COLLEGE,2624,2624,0,129,114,15,339,10,290,384,3253,523,626,0,3776,3453.6
2018,26,MONROE,2,INDEPENDENT,1,PRIVATE,1,4-Year/Grad,465000,800000050296,ST JOHN FISHER COLLEGE,2616,2616,0,129,114,15,302,15,243,407,3161,551,601,0,3712,3372.8
2019,26,MONROE,2,INDEPENDENT,1,PRIVATE,1,4-Year/Grad,465000,800000050296,ST JOHN FISHER COLLEGE,2535,2535,0,123,106,17,278,23,234,425,3047,571,601,0,3618,3267.2
2010,34,QUEENS,2,INDEPENDENT,1,PRIVATE,1,4-Year/Grad,465500,800000042596,ST. JOHN'S UNIVERSITY,11803,11687,116,3917,380,3537,1259,206,1880,2289,14942,6412,3154,16,21354,17245.67
2011,34,QUEENS,2,INDEPENDENT,1,PRIVATE,1,4-Year/Grad,465500,800000042596,ST. JOHN'S UNIVERSITY,11440,11390,50,4326,374,3952,1282,164,1660,2128,14382,6618,2766,2,21000,16740.8
2012,34,QUEENS,2,INDEPENDENT,1,PRIVATE,1,4-Year/Grad,465500,800000042596,ST. JOHN'S UNIVERSITY,10956,10844,112,4884,347,4537,1223,152,1712,2105,13891,7141,2857,9,21032,16421.8
2013,34,QUEENS,2,INDEPENDENT,1,PRIVATE,1,4-Year/Grad,465500,800000042596,ST. JOHN'S UNIVERSITY,10908,10821,87,4865,326,4539,1115,141,1661,1975,13684,6981,2791,5,20665,16152.07
2014,34,QUEENS,2,INDEPENDENT,1,PRIVATE,1,4-Year/Grad,465500,800000042596,ST. JOHN'S UNIVERSITY,10720,10558,162,5045,323,4722,1165,130,1446,1887,13331,7062,2791,5,20393,15819.47
2015,34,QUEENS,2,INDEPENDENT,1,PRIVATE,1,4-Year/Grad,465500,800000042596,ST. JOHN'S UNIVERSITY,11051,10978,73,5159,270,4889,1210,120,1429,1871,13690,7150,3251,2,20840,16206.07
2016,34,QUEENS,2,INDEPENDENT,1,PRIVATE,1,4-Year/Grad,465500,800000042596,ST. JOHN'S UNIVERSITY,10385,10365,20,3836,251,3585,1120,115,1318,1782,12823,5733,2928,11,18556,14860.47
2017,34,QUEENS,2,INDEPENDENT,1,PRIVATE,1,4-Year/Grad,465500,800000042596,ST. JOHN'S UNIVERSITY,10413,10388,25,4045,231,3814,1151,86,1363,1709,12927,5840,2731,15,18767,14993.33
2018,34,QUEENS,2,INDEPENDENT,1,PRIVATE,1,4-Year/Grad,465500,800000042596,ST. JOHN'S UNIVERSITY,10507,10459,48,3992,203,3789,1204,61,1419,1824,13130,5877,2768,15,19007,15214.67
2019,34,QUEENS,2,INDEPENDENT,1,PRIVATE,1,4-Year/Grad,465500,800000042596,ST. JOHN'S UNIVERSITY,10286,10231,55,4158,201,3957,1198,57,1456,1679,12940,5894,2837,18,18834,15020.4
2016,35,RICHMOND,2,INDEPENDENT,1,PRIVATE,1,4-Year/Grad,465510,800000041841,ST JOHNS UNIVERSITY-STATEN ISLAND,824,817,7,1093,34,1059,0,0,68,22,892,1115,243,1,2007,1265.13
2017,35,RICHMOND,2,INDEPENDENT,1,PRIVATE,1,4-Year/Grad,465510,800000041841,ST JOHNS UNIVERSITY-STATEN ISLAND,863,859,4,1188,21,1167,0,0,64,20,927,1208,187,0,2135,1331
2018,35,RICHMOND,2,INDEPENDENT,1,PRIVATE,1,4-Year/Grad,465510,800000041841,ST JOHNS UNIVERSITY-STATEN ISLAND,938,937,1,1149,17,1132,0,0,70,11,1008,1160,239,0,2168,1395.4
2019,35,RICHMOND,2,INDEPENDENT,1,PRIVATE,1,4-Year/Grad,465510,800000041841,ST JOHNS UNIVERSITY-STATEN ISLAND,946,943,3,1400,18,1382,0,0,69,12,1015,1412,190,2,2427,1486.47
2016,31,NEW YORK,2,INDEPENDENT,1,PRIVATE,1,4-Year/Grad,465530,800000059323,ST. JOHN'S UNIVERSITY - MANHATTAN BRANCH,298,297,1,4,4,0,0,0,114,69,412,73,65,0,485,440.93
2017,31,NEW YORK,2,INDEPENDENT,1,PRIVATE,1,4-Year/Grad,465530,800000059323,ST. JOHN'S UNIVERSITY - MANHATTAN BRANCH,251,251,0,2,2,0,0,0,86,64,337,66,34,0,403,363.27
2018,31,NEW YORK,2,INDEPENDENT,1,PRIVATE,1,4-Year/Grad,465530,800000059323,ST. JOHN'S UNIVERSITY - MANHATTAN BRANCH,296,296,0,2,2,0,0,0,86,62,382,64,94,0,446,407.47
2019,31,NEW YORK,2,INDEPENDENT,1,PRIVATE,1,4-Year/Grad,465530,800000059323,ST. JOHN'S UNIVERSITY - MANHATTAN BRANCH,295,295,0,3,3,0,0,0,103,45,398,48,88,0,446,417
2010,33,KINGS,2,INDEPENDENT,1,PRIVATE,1,4-Year/Grad,466500,800000045034,ST JOSEPH'S COLLEGE,4033,4030,3,1102,1011,91,0,0,45,717,4078,1819,699,55,5897,4732.13
2011,33,KINGS,2,INDEPENDENT,1,PRIVATE,1,4-Year/Grad,466500,800000045034,ST JOSEPH'S COLLEGE,3961,3949,12,1076,963,113,0,0,53,747,4014,1823,653,64,5837,4671.47
2012,33,KINGS,2,INDEPENDENT,1,PRIVATE,1,4-Year/Grad,466500,800000045034,ST JOSEPH'S COLLEGE,3817,3814,3,1055,928,127,0,0,81,730,3898,1785,577,52,5683,4541.67
2013,33,KINGS,2,INDEPENDENT,1,PRIVATE,1,4-Year/Grad,466500,800000045034,ST JOSEPH'S COLLEGE,3591,3588,3,938,862,76,0,0,108,717,3699,1655,545,43,5354,4298.47
2014,33,KINGS,2,INDEPENDENT,1,PRIVATE,1,4-Year/Grad,466500,800000045034,ST JOSEPH'S COLLEGE,3260,3255,5,878,798,80,0,0,106,735,3366,1613,496,15,4979,3952.67
2015,33,KINGS,2,INDEPENDENT,1,PRIVATE,1,4-Year/Grad,466500,800000045034,ST JOSEPH'S COLLEGE,3157,3155,2,721,658,63,0,0,128,743,3285,1464,507,9,4749,3822.53
2016,33,KINGS,2,INDEPENDENT,1,PRIVATE,1,4-Year/Grad,466500,800000045034,ST JOSEPH'S COLLEGE,789,787,2,176,166,10,0,0,69,171,858,347,196,2,1205,985.07
2017,33,KINGS,2,INDEPENDENT,1,PRIVATE,1,4-Year/Grad,466500,800000045034,ST JOSEPH'S COLLEGE,798,797,1,131,127,4,0,0,44,203,842,334,170,2,1176,966.87
2018,33,KINGS,2,INDEPENDENT,1,PRIVATE,1,4-Year/Grad,466500,800000045034,ST JOSEPH'S COLLEGE,824,823,1,119,114,5,0,0,41,195,865,314,200,2,1179,982.67
2019,33,KINGS,2,INDEPENDENT,1,PRIVATE,1,4-Year/Grad,466500,800000045034,ST JOSEPH'S COLLEGE,886,884,2,75,69,6,0,0,55,169,941,244,209,3,1185,1033.6
2016,58,SUFFOLK,2,INDEPENDENT,1,PRIVATE,1,4-Year/Grad,466510,800000037517,ST JOSEPH'S COLLEGE - SUFFOLK CAMPUS,2591,2585,6,484,444,40,0,0,136,703,2727,1187,420,11,3914,3169.53
2017,58,SUFFOLK,2,INDEPENDENT,1,PRIVATE,1,4-Year/Grad,466510,800000037517,ST JOSEPH'S COLLEGE - SUFFOLK CAMPUS,2613,2613,0,446,424,22,0,0,139,768,2752,1214,386,16,3966,3207.87
2018,58,SUFFOLK,2,INDEPENDENT,1,PRIVATE,1,4-Year/Grad,466510,800000037517,ST JOSEPH'S COLLEGE - SUFFOLK CAMPUS,2661,2660,1,487,460,27,0,0,140,827,2801,1314,447,16,4115,3294.13
2019,58,SUFFOLK,2,INDEPENDENT,1,PRIVATE,1,4-Year/Grad,466510,800000037517,ST JOSEPH'S COLLEGE - SUFFOLK CAMPUS,2611,2611,0,411,385,26,0,0,122,815,2733,1226,432,6,3959,3196
2010,42,ONONDAGA,2,INDEPENDENT,1,PRIVATE,0,2-Year,466700,800000070011,ST JOSEPH'S COLLEGE OF NURSING AT ST JOSEPH'S HOSPITAL HEALTH CENTER,167,167,0,109,109,0,0,0,0,0,167,109,10,0,276,203.33
2011,42,ONONDAGA,2,INDEPENDENT,1,PRIVATE,0,2-Year,466700,800000070011,ST JOSEPH'S COLLEGE OF NURSING AT ST JOSEPH'S HOSPITAL HEALTH CENTER,149,149,0,154,154,0,0,0,0,0,149,154,7,0,303,200.33
2012,42,ONONDAGA,2,INDEPENDENT,1,PRIVATE,0,2-Year,466700,800000070011,ST JOSEPH'S COLLEGE OF NURSING AT ST JOSEPH'S HOSPITAL HEALTH CENTER,139,139,0,159,159,0,0,0,0,0,139,159,7,0,298,192
2013,42,ONONDAGA,2,INDEPENDENT,1,PRIVATE,0,2-Year,466700,800000070011,ST JOSEPH'S COLLEGE OF NURSING AT ST JOSEPH'S HOSPITAL HEALTH CENTER,147,147,0,155,155,0,0,0,0,0,147,155,7,0,302,198.67
2014,42,ONONDAGA,2,INDEPENDENT,1,PRIVATE,0,2-Year,466700,800000070011,ST JOSEPH'S COLLEGE OF NURSING AT ST JOSEPH'S HOSPITAL HEALTH CENTER,147,147,0,160,160,0,0,0,0,0,147,160,4,0,307,200.33
2015,42,ONONDAGA,2,INDEPENDENT,1,PRIVATE,0,2-Year,466700,800000070011,ST JOSEPH'S COLLEGE OF NURSING AT ST JOSEPH'S HOSPITAL HEALTH CENTER,216,216,0,75,75,0,0,0,0,0,216,75,2,0,291,241
2016,42,ONONDAGA,2,INDEPENDENT,1,PRIVATE,0,2-Year,466700,800000070011,ST JOSEPH'S COLLEGE OF NURSING AT ST JOSEPH'S HOSPITAL HEALTH CENTER,240,240,0,54,54,0,0,0,0,0,240,54,2,0,294,258
2017,42,ONONDAGA,2,INDEPENDENT,1,PRIVATE,0,2-Year,466700,800000070011,ST JOSEPH'S COLLEGE OF NURSING AT ST JOSEPH'S HOSPITAL HEALTH CENTER,248,248,0,51,51,0,0,0,0,0,248,51,0,2,299,265
2018,42,ONONDAGA,2,INDEPENDENT,1,PRIVATE,0,2-Year,466700,800000070011,ST JOSEPH'S COLLEGE OF NURSING AT ST JOSEPH'S HOSPITAL HEALTH CENTER,73,73,0,251,251,0,0,0,0,0,73,251,1,1,324,156.67
2019,42,ONONDAGA,2,INDEPENDENT,1,PRIVATE,0,2-Year,466700,800000070011,ST JOSEPH'S COLLEGE OF NURSING AT ST JOSEPH'S HOSPITAL HEALTH CENTER,270,270,0,68,68,0,0,0,0,0,270,68,4,2,338,292.67
2010,66,WESTCHESTER,2,INDEPENDENT,1,PRIVATE,1,4-Year/Grad,467000,800000034662,SAINT JOSEPH'S SEMINARY AND COLLEGE,0,0,0,0,0,0,45,0,0,73,45,73,0,0,118,74.2
2011,66,WESTCHESTER,2,INDEPENDENT,1,PRIVATE,1,4-Year/Grad,467000,800000034662,SAINT JOSEPH'S SEMINARY AND COLLEGE,0,0,0,0,0,0,50,0,2,68,52,68,0,0,120,79.2
2012,66,WESTCHESTER,2,INDEPENDENT,1,PRIVATE,1,4-Year/Grad,467000,800000034662,SAINT JOSEPH'S SEMINARY AND COLLEGE,0,0,0,0,0,0,97,0,0,86,97,86,0,0,183,131.4
2013,66,WESTCHESTER,2,INDEPENDENT,1,PRIVATE,1,4-Year/Grad,467000,800000034662,SAINT JOSEPH'S SEMINARY AND COLLEGE,0,0,0,0,0,0,98,0,0,52,98,52,0,0,150,118.8
2014,66,WESTCHESTER,2,INDEPENDENT,1,PRIVATE,1,4-Year/Grad,467000,800000034662,SAINT JOSEPH'S SEMINARY AND COLLEGE,0,0,0,0,0,0,83,0,18,128,101,128,0,0,229,152.2
2015,66,WESTCHESTER,2,INDEPENDENT,1,PRIVATE,1,4-Year/Grad,467000,800000034662,SAINT JOSEPH'S SEMINARY AND COLLEGE,0,0,0,0,0,0,86,0,19,98,105,98,0,0,203,144.2
2016,66,WESTCHESTER,2,INDEPENDENT,1,PRIVATE,1,4-Year/Grad,467000,800000034662,SAINT JOSEPH'S SEMINARY AND COLLEGE,0,0,0,0,0,0,74,0,18,63,92,63,0,0,155,117.2
2017,66,WESTCHESTER,2,INDEPENDENT,1,PRIVATE,1,4-Year/Grad,467000,800000034662,SAINT JOSEPH'S SEMINARY AND COLLEGE,0,0,0,0,0,0,74,0,0,0,74,0,0,0,74,74
2019,66,WESTCHESTER,2,INDEPENDENT,1,PRIVATE,1,4-Year/Grad,467000,800000034662,SAINT JOSEPH'S SEMINARY AND COLLEGE,0,0,0,0,0,0,0,0,67,42,67,42,0,0,109,83.8
2019,58,SUFFOLK,2,INDEPENDENT,1,PRIVATE,1,4-Year/Grad,467010,800000089818,ST. JOSEPH'S SEMINARY & COLLEGE-HUNTINGTON,0,0,0,0,0,0,0,0,0,40,0,40,0,0,40,16
2019,35,RICHMOND,2,INDEPENDENT,1,PRIVATE,1,4-Year/Grad,467020,800000089819,ST. JOSEPH'S SEMINARY & COLLEGE-DOUGLASTON,0,0,0,0,0,0,0,0,17,18,17,18,0,0,35,24.2
2019,66,WESTCHESTER,2,INDEPENDENT,1,PRIVATE,1,4-Year/Grad,467030,800000089820,ST. JOSEPH'S SEMINARY & COLLEGE-SOMERS,0,0,0,0,0,0,0,0,0,3,0,3,0,0,3,1.2
2010,51,SAINT LAWRENCE,2,INDEPENDENT,1,PRIVATE,1,4-Year/Grad,467500,800000034135,SAINT LAWRENCE UNIVERSITY,2300,2294,6,27,1,26,0,0,15,81,2315,108,609,0,2423,2356.4
2011,51,SAINT LAWRENCE,2,INDEPENDENT,1,PRIVATE,1,4-Year/Grad,467500,800000034135,SAINT LAWRENCE UNIVERSITY,2335,2333,2,26,2,24,0,0,23,73,2358,99,645,0,2457,2395.87
2012,51,SAINT LAWRENCE,2,INDEPENDENT,1,PRIVATE,1,4-Year/Grad,467500,800000034135,SAINT LAWRENCE UNIVERSITY,2374,2370,4,24,4,20,0,0,16,74,2390,98,642,0,2488,2427.6
2013,51,SAINT LAWRENCE,2,INDEPENDENT,1,PRIVATE,1,4-Year/Grad,467500,800000034135,SAINT LAWRENCE UNIVERSITY,2397,2391,6,17,0,17,0,0,13,79,2410,96,629,0,2506,2447.27
2014,51,SAINT LAWRENCE,2,INDEPENDENT,1,PRIVATE,1,4-Year/Grad,467500,800000034135,SAINT LAWRENCE UNIVERSITY,2371,2369,2,35,2,33,0,0,37,65,2408,100,600,0,2508,2445.67
2015,51,SAINT LAWRENCE,2,INDEPENDENT,1,PRIVATE,1,4-Year/Grad,467500,800000034135,SAINT LAWRENCE UNIVERSITY,2404,2402,2,31,2,29,0,0,42,51,2446,82,679,0,2528,2476.73
2016,51,SAINT LAWRENCE,2,INDEPENDENT,1,PRIVATE,1,4-Year/Grad,467500,800000034135,SAINT LAWRENCE UNIVERSITY,2345,2341,4,32,3,29,0,0,37,50,2382,82,565,0,2464,2412.67
2017,51,SAINT LAWRENCE,2,INDEPENDENT,1,PRIVATE,1,4-Year/Grad,467500,800000034135,SAINT LAWRENCE UNIVERSITY,2372,2370,2,42,3,39,0,0,31,48,2403,90,695,0,2493,2436.2
2018,51,SAINT LAWRENCE,2,INDEPENDENT,1,PRIVATE,1,4-Year/Grad,467500,800000034135,SAINT LAWRENCE UNIVERSITY,2407,2404,3,34,2,32,0,0,42,39,2449,73,640,0,2522,2475.93
2019,51,SAINT LAWRENCE,2,INDEPENDENT,1,PRIVATE,1,4-Year/Grad,467500,800000034135,SAINT LAWRENCE UNIVERSITY,2368,2359,9,15,1,14,0,0,18,24,2386,39,605,0,2425,2400.6
2010,50,ROCKLAND,2,INDEPENDENT,1,PRIVATE,1,4-Year/Grad,468000,800000039221,ST THOMAS AQUINAS COLLEGE,1288,1284,4,561,76,485,0,0,93,135,1381,696,292,1,2077,1622
2011,50,ROCKLAND,2,INDEPENDENT,1,PRIVATE,1,4-Year/Grad,468000,800000039221,ST THOMAS AQUINAS COLLEGE,1277,1274,3,566,68,498,0,0,64,118,1341,684,304,3,2025,1576.87
2012,50,ROCKLAND,2,INDEPENDENT,1,PRIVATE,1,4-Year/Grad,468000,800000039221,ST THOMAS AQUINAS COLLEGE,1243,1240,3,553,55,498,0,0,53,108,1296,661,274,0,1957,1523.53
2013,50,ROCKLAND,2,INDEPENDENT,1,PRIVATE,1,4-Year/Grad,468000,800000039221,ST THOMAS AQUINAS COLLEGE,1259,1168,91,542,59,483,0,0,48,123,1307,665,332,5,1972,1536.87
2014,50,ROCKLAND,2,INDEPENDENT,1,PRIVATE,1,4-Year/Grad,468000,800000039221,ST THOMAS AQUINAS COLLEGE,1147,1146,1,633,61,572,0,0,43,119,1190,752,234,13,1942,1448.6
2015,50,ROCKLAND,2,INDEPENDENT,1,PRIVATE,1,4-Year/Grad,468000,800000039221,ST THOMAS AQUINAS COLLEGE,1117,1117,0,579,53,526,0,0,45,95,1162,674,272,18,1836,1393
2016,50,ROCKLAND,2,INDEPENDENT,1,PRIVATE,1,4-Year/Grad,468000,800000039221,ST THOMAS AQUINAS COLLEGE,1130,1091,39,591,61,530,0,0,47,83,1177,674,255,5,1851,1407.2
2017,50,ROCKLAND,2,INDEPENDENT,1,PRIVATE,1,4-Year/Grad,468000,800000039221,ST THOMAS AQUINAS COLLEGE,1091,1059,32,687,55,632,0,0,55,82,1146,769,246,0,1915,1407.8
2018,50,ROCKLAND,2,INDEPENDENT,1,PRIVATE,1,4-Year/Grad,468000,800000039221,ST THOMAS AQUINAS COLLEGE,1140,1139,1,44,41,3,0,0,65,73,1205,117,269,5,1322,1248.87
2019,50,ROCKLAND,2,INDEPENDENT,1,PRIVATE,1,4-Year/Grad,468000,800000039221,ST THOMAS AQUINAS COLLEGE,1134,1110,24,663,38,625,0,0,64,76,1198,739,243,2,1937,1449.4
2010,66,WESTCHESTER,2,INDEPENDENT,1,PRIVATE,1,4-Year/Grad,468500,800000034646,ST VLADIMIR'S ORTHODOX THEOL SEMINRY,0,0,0,0,0,0,44,5,9,5,53,10,0,0,63,57
2011,66,WESTCHESTER,2,INDEPENDENT,1,PRIVATE,1,4-Year/Grad,468500,800000034646,ST VLADIMIR'S ORTHODOX THEOL SEMINRY,0,0,0,0,0,0,33,4,9,7,42,11,0,0,53,46.4
2012,66,WESTCHESTER,2,INDEPENDENT,1,PRIVATE,1,4-Year/Grad,468500,800000034646,ST VLADIMIR'S ORTHODOX THEOL SEMINRY,0,0,0,0,0,0,28,1,18,8,46,9,0,0,55,49.6
2013,66,WESTCHESTER,2,INDEPENDENT,1,PRIVATE,1,4-Year/Grad,468500,800000034646,ST VLADIMIR'S ORTHODOX THEOL SEMINRY,0,0,0,0,0,0,40,2,26,13,66,15,0,0,81,72
2014,66,WESTCHESTER,2,INDEPENDENT,1,PRIVATE,1,4-Year/Grad,468500,800000034646,ST VLADIMIR'S ORTHODOX THEOL SEMINRY,0,0,0,0,0,0,38,2,36,12,74,14,0,0,88,79.6
2015,66,WESTCHESTER,2,INDEPENDENT,1,PRIVATE,1,4-Year/Grad,468500,800000034646,ST VLADIMIR'S ORTHODOX THEOL SEMINRY,0,0,0,0,0,0,38,2,28,11,66,13,0,0,79,71.2
2016,66,WESTCHESTER,2,INDEPENDENT,1,PRIVATE,1,4-Year/Grad,468500,800000034646,ST VLADIMIR'S ORTHODOX THEOL SEMINRY,0,0,0,0,0,0,37,4,34,13,71,17,0,0,88,77.8
2017,66,WESTCHESTER,2,INDEPENDENT,1,PRIVATE,1,4-Year/Grad,468500,800000034646,ST VLADIMIR'S ORTHODOX THEOL SEMINRY,0,0,0,0,0,0,44,2,27,10,71,12,0,0,83,75.8
2018,66,WESTCHESTER,2,INDEPENDENT,1,PRIVATE,1,4-Year/Grad,468500,800000034646,ST VLADIMIR'S ORTHODOX THEOL SEMINRY,0,0,0,0,0,0,46,1,30,9,76,10,0,0,86,80
2019,66,WESTCHESTER,2,INDEPENDENT,1,PRIVATE,1,4-Year/Grad,468500,800000034646,ST VLADIMIR'S ORTHODOX THEOL SEMINRY,0,0,0,0,0,0,45,1,30,9,75,10,0,0,85,79
2010,50,ROCKLAND,2,INDEPENDENT,1,PRIVATE,0,2-Year,468600,800000065117,SALVATION ARMY COLLEGE FOR OFFICER TRAINING,80,80,0,0,0,0,0,0,0,0,80,0,36,0,80,80
2011,50,ROCKLAND,2,INDEPENDENT,1,PRIVATE,0,2-Year,468600,800000065117,SALVATION ARMY COLLEGE FOR OFFICER TRAINING,73,73,0,0,0,0,0,0,0,0,73,0,37,0,73,73
2012,50,ROCKLAND,2,INDEPENDENT,1,PRIVATE,0,2-Year,468600,800000065117,SALVATION ARMY COLLEGE FOR OFFICER TRAINING,100,100,0,0,0,0,0,0,0,0,100,0,61,0,100,100
2013,50,ROCKLAND,2,INDEPENDENT,1,PRIVATE,0,2-Year,468600,800000065117,SALVATION ARMY COLLEGE FOR OFFICER TRAINING,113,113,0,0,0,0,0,0,0,0,113,0,53,0,113,113
2014,50,ROCKLAND,2,INDEPENDENT,1,PRIVATE,0,2-Year,468600,800000065117,SALVATION ARMY COLLEGE FOR OFFICER TRAINING,95,95,0,0,0,0,0,0,0,0,95,0,45,0,95,95
2015,50,ROCKLAND,2,INDEPENDENT,1,PRIVATE,0,2-Year,468600,800000065117,SALVATION ARMY COLLEGE FOR OFFICER TRAINING,122,122,0,0,0,0,0,0,0,0,122,0,79,0,122,122
2016,50,ROCKLAND,2,INDEPENDENT,1,PRIVATE,0,2-Year,468600,800000065117,SALVATION ARMY COLLEGE FOR OFFICER TRAINING,127,127,0,0,0,0,0,0,0,0,127,0,50,0,127,127
2017,50,ROCKLAND,2,INDEPENDENT,1,PRIVATE,0,2-Year,468600,800000065117,SALVATION ARMY COLLEGE FOR OFFICER TRAINING,73,73,0,0,0,0,0,0,0,0,73,0,25,0,73,73
2018,50,ROCKLAND,2,INDEPENDENT,1,PRIVATE,0,2-Year,468600,800000065117,SALVATION ARMY COLLEGE FOR OFFICER TRAINING,62,62,0,0,0,0,0,0,0,0,62,0,40,0,62,62
2019,50,ROCKLAND,2,INDEPENDENT,1,PRIVATE,0,2-Year,468600,800000065117,SALVATION ARMY COLLEGE FOR OFFICER TRAINING,61,61,0,0,0,0,0,0,0,0,61,0,24,0,61,61
2010,49,RENSSELAER,2,INDEPENDENT,1,PRIVATE,0,2-Year,468700,800000039408,SAMARITAN HOSPITAL SCHOOL OF NURSING,37,37,0,88,88,0,0,0,0,0,37,88,3,0,125,66.33
2011,49,RENSSELAER,2,INDEPENDENT,1,PRIVATE,0,2-Year,468700,800000039408,SAMARITAN HOSPITAL SCHOOL OF NURSING,13,13,0,124,124,0,0,0,0,0,13,124,1,0,137,54.33
2012,49,RENSSELAER,2,INDEPENDENT,1,PRIVATE,0,2-Year,468700,800000039408,SAMARITAN HOSPITAL SCHOOL OF NURSING,23,23,0,122,122,0,0,0,0,0,23,122,2,0,145,63.67
2013,49,RENSSELAER,2,INDEPENDENT,1,PRIVATE,0,2-Year,468700,800000039408,SAMARITAN HOSPITAL SCHOOL OF NURSING,16,16,0,147,147,0,0,0,0,0,16,147,1,1,163,65
2014,49,RENSSELAER,2,INDEPENDENT,1,PRIVATE,0,2-Year,468700,800000039408,SAMARITAN HOSPITAL SCHOOL OF NURSING,6,6,0,160,160,0,0,0,0,0,6,160,1,0,166,59.33
2015,49,RENSSELAER,2,INDEPENDENT,1,PRIVATE,0,2-Year,468700,800000039408,SAMARITAN HOSPITAL SCHOOL OF NURSING,1,1,0,130,130,0,0,0,0,0,1,130,1,0,131,44.33
2016,49,RENSSELAER,2,INDEPENDENT,1,PRIVATE,0,2-Year,468700,800000039408,SAMARITAN HOSPITAL SCHOOL OF NURSING,11,11,0,122,122,0,0,0,0,0,11,122,0,0,133,51.67
2017,49,RENSSELAER,2,INDEPENDENT,1,PRIVATE,0,2-Year,468700,800000039408,SAMARITAN HOSPITAL SCHOOL OF NURSING,20,20,0,128,128,0,0,0,0,0,20,128,3,2,148,62.67
2018,49,RENSSELAER,2,INDEPENDENT,1,PRIVATE,0,2-Year,468700,800000039408,SAMARITAN HOSPITAL SCHOOL OF NURSING,6,6,0,120,120,0,0,0,0,0,6,120,1,0,126,46
2019,49,RENSSELAER,2,INDEPENDENT,1,PRIVATE,0,2-Year,468700,800000039408,SAMARITAN HOSPITAL SCHOOL OF NURSING,8,8,0,134,134,0,0,0,0,0,8,134,2,0,142,52.67
2010,66,WESTCHESTER,2,INDEPENDENT,1,PRIVATE,1,4-Year/Grad,469000,800000035632,SARAH LAWRENCE COLLEGE,1288,1227,61,40,30,10,0,0,255,87,1543,127,337,1,1670,1591.13
2011,66,WESTCHESTER,2,INDEPENDENT,1,PRIVATE,1,4-Year/Grad,469000,800000035632,SARAH LAWRENCE COLLEGE,1369,1313,56,44,20,24,0,0,263,68,1632,112,373,1,1744,1673.87
2012,66,WESTCHESTER,2,INDEPENDENT,1,PRIVATE,1,4-Year/Grad,469000,800000035632,SARAH LAWRENCE COLLEGE,1374,1318,56,46,24,22,0,0,259,57,1633,103,344,0,1736,1671.13
2013,66,WESTCHESTER,2,INDEPENDENT,1,PRIVATE,1,4-Year/Grad,469000,800000035632,SARAH LAWRENCE COLLEGE,1441,1391,50,30,11,19,0,0,260,51,1701,81,427,0,1782,1731.4
2014,66,WESTCHESTER,2,INDEPENDENT,1,PRIVATE,1,4-Year/Grad,469000,800000035632,SARAH LAWRENCE COLLEGE,1414,1350,64,23,16,7,0,0,292,32,1706,55,355,1,1761,1726.47
2015,66,WESTCHESTER,2,INDEPENDENT,1,PRIVATE,1,4-Year/Grad,469000,800000035632,SARAH LAWRENCE COLLEGE,1327,1266,61,21,17,4,0,0,245,50,1572,71,353,0,1643,1599
2016,66,WESTCHESTER,2,INDEPENDENT,1,PRIVATE,1,4-Year/Grad,469000,800000035632,SARAH LAWRENCE COLLEGE,1417,1361,56,21,16,5,0,0,251,47,1668,68,377,0,1736,1693.8
2017,66,WESTCHESTER,2,INDEPENDENT,1,PRIVATE,1,4-Year/Grad,469000,800000035632,SARAH LAWRENCE COLLEGE,1383,1340,43,16,15,1,0,0,256,41,1639,57,393,0,1696,1660.73
2018,66,WESTCHESTER,2,INDEPENDENT,1,PRIVATE,1,4-Year/Grad,469000,800000035632,SARAH LAWRENCE COLLEGE,1396,1357,39,14,12,2,0,0,259,40,1655,54,425,0,1709,1675.67
2019,66,WESTCHESTER,2,INDEPENDENT,1,PRIVATE,1,4-Year/Grad,469000,800000035632,SARAH LAWRENCE COLLEGE,1418,1351,67,15,13,2,0,0,204,33,1622,48,398,0,1670,1640.2
2010,58,SUFFOLK,2,INDEPENDENT,1,PRIVATE,1,4-Year/Grad,469500,800000037366,SEMINARY OF THE IMMACULATE CONCEPTION-ROCKVILLE,0,0,0,0,0,0,37,1,2,88,39,89,0,0,128,74.6
2011,58,SUFFOLK,2,INDEPENDENT,1,PRIVATE,1,4-Year/Grad,469500,800000037366,SEMINARY OF THE IMMACULATE CONCEPTION-ROCKVILLE,0,0,0,0,0,0,42,0,0,78,42,78,0,0,120,73.2
2012,58,SUFFOLK,2,INDEPENDENT,1,PRIVATE,1,4-Year/Grad,469500,800000037366,SEMINARY OF THE IMMACULATE CONCEPTION-ROCKVILLE,0,0,0,0,0,0,42,0,0,64,42,64,0,0,106,67.6
2010,01,ALBANY,2,INDEPENDENT,1,PRIVATE,1,4-Year/Grad,470000,800000034130,SIENA COLLEGE,3207,3201,6,164,106,58,0,0,30,3,3237,167,773,1,3404,3292.87
2011,01,ALBANY,2,INDEPENDENT,1,PRIVATE,1,4-Year/Grad,470000,800000034130,SIENA COLLEGE,3132,3128,4,150,116,34,0,0,46,4,3178,154,782,1,3332,3229.6
2012,01,ALBANY,2,INDEPENDENT,1,PRIVATE,1,4-Year/Grad,470000,800000034130,SIENA COLLEGE,3046,3033,13,167,115,52,0,0,50,4,3096,171,734,1,3267,3153.27
2013,01,ALBANY,2,INDEPENDENT,1,PRIVATE,1,4-Year/Grad,470000,800000034130,SIENA COLLEGE,3007,3005,2,144,97,47,0,0,52,4,3059,148,766,30,3207,3108.6
2014,01,ALBANY,2,INDEPENDENT,1,PRIVATE,1,4-Year/Grad,470000,800000034130,SIENA COLLEGE,2990,2984,6,143,102,41,0,0,36,10,3026,153,709,21,3179,3077.67
2015,01,ALBANY,2,INDEPENDENT,1,PRIVATE,1,4-Year/Grad,470000,800000034130,SIENA COLLEGE,3007,2989,18,112,71,41,0,0,48,9,3055,121,757,28,3176,3095.93
2016,01,ALBANY,2,INDEPENDENT,1,PRIVATE,1,4-Year/Grad,470000,800000034130,SIENA COLLEGE,3061,3059,2,117,82,35,0,0,49,12,3110,129,763,7,3239,3153.8
2017,01,ALBANY,2,INDEPENDENT,1,PRIVATE,1,4-Year/Grad,470000,800000034130,SIENA COLLEGE,3039,3036,3,288,95,193,0,0,51,11,3090,299,776,13,3389,3190.4
2018,01,ALBANY,2,INDEPENDENT,1,PRIVATE,1,4-Year/Grad,470000,800000034130,SIENA COLLEGE,3026,3026,0,238,109,129,0,0,49,8,3075,246,745,1,3321,3157.53
2019,01,ALBANY,2,INDEPENDENT,1,PRIVATE,1,4-Year/Grad,470000,800000034130,SIENA COLLEGE,3028,3025,3,342,121,221,0,0,73,35,3101,377,841,5,3478,3229
2010,52,SARATOGA,2,INDEPENDENT,1,PRIVATE,1,4-Year/Grad,470500,800000038544,SKIDMORE COLLEGE,2690,2676,14,44,27,17,0,0,0,49,2690,93,768,1,2783,2724.27
2011,52,SARATOGA,2,INDEPENDENT,1,PRIVATE,1,4-Year/Grad,470500,800000038544,SKIDMORE COLLEGE,2648,2635,13,41,20,21,0,0,0,41,2648,82,663,0,2730,2678.07
2012,52,SARATOGA,2,INDEPENDENT,1,PRIVATE,1,4-Year/Grad,470500,800000038544,SKIDMORE COLLEGE,2621,2614,7,39,17,22,0,0,0,29,2621,68,647,7,2689,2645.6
2013,52,SARATOGA,2,INDEPENDENT,1,PRIVATE,1,4-Year/Grad,470500,800000038544,SKIDMORE COLLEGE,2647,2633,14,37,13,24,0,0,0,18,2647,55,661,5,2702,2666.53
2014,52,SARATOGA,2,INDEPENDENT,1,PRIVATE,1,4-Year/Grad,470500,800000038544,SKIDMORE COLLEGE,2609,2597,12,23,15,8,0,0,0,14,2609,37,724,0,2646,2622.27
2015,52,SARATOGA,2,INDEPENDENT,1,PRIVATE,1,4-Year/Grad,470500,800000038544,SKIDMORE COLLEGE,2603,2600,3,31,19,12,0,0,0,8,2603,39,686,0,2642,2616.53
2016,52,SARATOGA,2,INDEPENDENT,1,PRIVATE,1,4-Year/Grad,470500,800000038544,SKIDMORE COLLEGE,2643,2637,6,37,24,13,0,0,0,6,2643,43,714,0,2686,2657.73
2017,52,SARATOGA,2,INDEPENDENT,1,PRIVATE,1,4-Year/Grad,470500,800000038544,SKIDMORE COLLEGE,2636,2629,7,44,30,14,0,0,0,4,2636,48,661,0,2684,2652.27
2018,52,SARATOGA,2,INDEPENDENT,1,PRIVATE,1,4-Year/Grad,470500,800000038544,SKIDMORE COLLEGE,2585,2580,5,27,18,9,0,0,0,1,2585,28,678,0,2613,2594.4
2019,52,SARATOGA,2,INDEPENDENT,1,PRIVATE,1,4-Year/Grad,470500,800000038544,SKIDMORE COLLEGE,2622,2617,5,40,32,8,0,0,0,1,2622,41,733,3,2663,2635.73
2010,31,NEW YORK,2,INDEPENDENT,1,PRIVATE,1,4-Year/Grad,470600,800000065118,"LOUIS V. GERSTNER GRAD SCHO OF BIOMED SCI, MEMORIAL SLOAN-KETTERING CANCER CENTER",0,0,0,0,0,0,0,0,43,0,43,0,0,0,43,43
2011,31,NEW YORK,2,INDEPENDENT,1,PRIVATE,1,4-Year/Grad,470600,800000065118,"LOUIS V. GERSTNER GRAD SCHO OF BIOMED SCI, MEMORIAL SLOAN-KETTERING CANCER CENTER",0,0,0,0,0,0,0,0,52,0,52,0,0,0,52,52
2012,31,NEW YORK,2,INDEPENDENT,1,PRIVATE,1,4-Year/Grad,470600,800000065118,"LOUIS V. GERSTNER GRAD SCHO OF BIOMED SCI, MEMORIAL SLOAN-KETTERING CANCER CENTER",0,0,0,0,0,0,0,0,60,0,60,0,0,0,60,60
2013,31,NEW YORK,2,INDEPENDENT,1,PRIVATE,1,4-Year/Grad,470600,800000065118,"LOUIS V. GERSTNER GRAD SCHO OF BIOMED SCI, MEMORIAL SLOAN-KETTERING CANCER CENTER",0,0,0,0,0,0,0,0,64,0,64,0,0,0,64,64
2014,31,NEW YORK,2,INDEPENDENT,1,PRIVATE,1,4-Year/Grad,470600,800000065118,"LOUIS V. GERSTNER GRAD SCHO OF BIOMED SCI, MEMORIAL SLOAN-KETTERING CANCER CENTER",0,0,0,0,0,0,0,0,60,0,60,0,0,0,60,60
2015,31,NEW YORK,2,INDEPENDENT,1,PRIVATE,1,4-Year/Grad,470600,800000065118,"LOUIS V. GERSTNER GRAD SCHO OF BIOMED SCI, MEMORIAL SLOAN-KETTERING CANCER CENTER",0,0,0,0,0,0,0,0,68,0,68,0,0,0,68,68
2016,31,NEW YORK,2,INDEPENDENT,1,PRIVATE,1,4-Year/Grad,470600,800000065118,"LOUIS V. GERSTNER GRAD SCHO OF BIOMED SCI, MEMORIAL SLOAN-KETTERING CANCER CENTER",0,0,0,0,0,0,0,0,67,0,67,0,0,0,67,67
2017,31,NEW YORK,2,INDEPENDENT,1,PRIVATE,1,4-Year/Grad,470600,800000065118,"LOUIS V. GERSTNER GRAD SCHO OF BIOMED SCI, MEMORIAL SLOAN-KETTERING CANCER CENTER",0,0,0,0,0,0,0,0,70,0,70,0,0,0,70,70
2018,31,NEW YORK,2,INDEPENDENT,1,PRIVATE,1,4-Year/Grad,470600,800000065118,"LOUIS V. GERSTNER GRAD SCHO OF BIOMED SCI, MEMORIAL SLOAN-KETTERING CANCER CENTER",0,0,0,0,0,0,0,0,74,0,74,0,0,0,74,74
2019,31,NEW YORK,2,INDEPENDENT,1,PRIVATE,1,4-Year/Grad,470600,800000065118,"LOUIS V. GERSTNER GRAD SCHO OF BIOMED SCI, MEMORIAL SLOAN-KETTERING CANCER CENTER",0,0,0,0,0,0,0,0,77,0,77,0,0,0,77,77
2010,42,ONONDAGA,2,INDEPENDENT,1,PRIVATE,1,4-Year/Grad,471000,800000040733,SYRACUSE UNIVERSITY,13468,13185,283,1529,529,1000,652,7,3748,1884,17868,3420,3460,33,21288,19134.07
2011,42,ONONDAGA,2,INDEPENDENT,1,PRIVATE,1,4-Year/Grad,471000,800000040733,SYRACUSE UNIVERSITY,13947,13636,311,1077,544,533,664,7,3812,1737,18423,2821,3400,24,21244,19479.6
2012,42,ONONDAGA,2,INDEPENDENT,1,PRIVATE,1,4-Year/Grad,471000,800000040733,SYRACUSE UNIVERSITY,14144,13896,248,5887,504,5383,675,8,3969,1653,18788,7548,3384,10,26336,21414.73
2013,42,ONONDAGA,2,INDEPENDENT,1,PRIVATE,1,4-Year/Grad,471000,800000040733,SYRACUSE UNIVERSITY,14379,14144,235,6590,542,6048,641,8,4039,1558,19059,8156,3478,11,27215,21882.07
2014,42,ONONDAGA,2,INDEPENDENT,1,PRIVATE,1,4-Year/Grad,471000,800000040733,SYRACUSE UNIVERSITY,14501,14188,313,6664,539,6125,581,8,4247,1505,19329,8177,3463,9,27506,22155.53
2015,42,ONONDAGA,2,INDEPENDENT,1,PRIVATE,1,4-Year/Grad,471000,800000040733,SYRACUSE UNIVERSITY,14521,14067,454,7223,493,6730,574,7,4200,1872,19295,9102,3478,3,28397,22454.27
2016,42,ONONDAGA,2,INDEPENDENT,1,PRIVATE,1,4-Year/Grad,471000,800000040733,SYRACUSE UNIVERSITY,14589,14269,320,7120,453,6667,569,11,3977,2261,19135,9392,3704,8,28527,22417.13
2017,42,ONONDAGA,2,INDEPENDENT,1,PRIVATE,1,4-Year/Grad,471000,800000040733,SYRACUSE UNIVERSITY,14642,14285,357,6970,442,6528,600,3,3965,2725,19207,9698,3644,5,28905,22621.53
2018,42,ONONDAGA,2,INDEPENDENT,1,PRIVATE,1,4-Year/Grad,471000,800000040733,SYRACUSE UNIVERSITY,14612,14274,338,7313,423,6890,619,11,3914,3088,19145,10412,3595,4,29557,22822.27
2019,42,ONONDAGA,2,INDEPENDENT,1,PRIVATE,1,4-Year/Grad,471000,800000040733,SYRACUSE UNIVERSITY,14682,14375,307,7604,417,7187,600,92,3911,3002,19193,10698,3641,19,29891,22965.27
2010,31,NEW YORK,2,INDEPENDENT,1,PRIVATE,1,4-Year/Grad,471500,800000047065,TEACHERS COLLEGE,0,0,0,0,0,0,0,0,2373,2906,2373,2906,0,0,5279,3535.4
2011,31,NEW YORK,2,INDEPENDENT,1,PRIVATE,1,4-Year/Grad,471500,800000047065,TEACHERS COLLEGE,0,0,0,0,0,0,0,0,3164,2143,3164,2143,0,0,5307,4021.2
2012,31,NEW YORK,2,INDEPENDENT,1,PRIVATE,1,4-Year/Grad,471500,800000047065,TEACHERS COLLEGE,0,0,0,0,0,0,0,0,2616,2323,2616,2323,0,0,4939,3545.2
2013,31,NEW YORK,2,INDEPENDENT,1,PRIVATE,1,4-Year/Grad,471500,800000047065,TEACHERS COLLEGE,0,0,0,0,0,0,0,0,2762,2150,2762,2150,0,0,4912,3622
2014,31,NEW YORK,2,INDEPENDENT,1,PRIVATE,1,4-Year/Grad,471500,800000047065,TEACHERS COLLEGE,0,0,0,0,0,0,0,0,2777,2109,2777,2109,0,0,4886,3620.6
2015,31,NEW YORK,2,INDEPENDENT,1,PRIVATE,1,4-Year/Grad,471500,800000047065,TEACHERS COLLEGE,0,0,0,0,0,0,0,0,2898,2134,2898,2134,0,0,5032,3751.6
2016,31,NEW YORK,2,INDEPENDENT,1,PRIVATE,1,4-Year/Grad,471500,800000047065,TEACHERS COLLEGE,0,0,0,0,0,0,0,0,3061,1981,3061,1981,0,0,5042,3853.4
2017,31,NEW YORK,2,INDEPENDENT,1,PRIVATE,1,4-Year/Grad,471500,800000047065,TEACHERS COLLEGE,0,0,0,0,0,0,0,0,2889,1900,2889,1900,0,0,4789,3649
2018,31,NEW YORK,2,INDEPENDENT,1,PRIVATE,1,4-Year/Grad,471500,800000047065,TEACHERS COLLEGE,0,0,0,0,0,0,0,0,2799,1860,2799,1860,0,0,4659,3543
2019,31,NEW YORK,2,INDEPENDENT,1,PRIVATE,1,4-Year/Grad,471500,800000047065,TEACHERS COLLEGE,0,0,0,0,0,0,0,0,2438,2088,2438,2088,0,0,4526,3273.2
2010,31,NEW YORK,2,INDEPENDENT,1,PRIVATE,1,4-Year/Grad,472000,800000047858,TOURO COLLEGE,6217,6217,0,1387,1387,0,1374,243,1061,4583,8652,6213,733,190,14865,11044.73
2011,31,NEW YORK,2,INDEPENDENT,1,PRIVATE,1,4-Year/Grad,472000,800000047858,TOURO COLLEGE,5603,5603,0,1491,1491,0,1733,242,811,4315,8147,6048,1159,252,14195,10466.8
2012,31,NEW YORK,2,INDEPENDENT,1,PRIVATE,1,4-Year/Grad,472000,800000047858,TOURO COLLEGE,5855,5749,106,1889,1118,771,1595,224,891,3929,8341,6042,864,105,14383,10631.87
2013,31,NEW YORK,2,INDEPENDENT,1,PRIVATE,1,4-Year/Grad,472000,800000047858,TOURO COLLEGE,5271,5138,133,2031,1120,911,1568,250,980,3877,7819,6158,785,81,13977,10146.8
2014,31,NEW YORK,2,INDEPENDENT,1,PRIVATE,1,4-Year/Grad,472000,800000047858,TOURO COLLEGE,5228,5132,96,2004,1125,879,1447,325,778,3362,7453,5691,877,114,13144,9595.8
2015,31,NEW YORK,2,INDEPENDENT,1,PRIVATE,1,4-Year/Grad,472000,800000047858,TOURO COLLEGE,5531,5442,89,1870,1086,784,1998,45,1373,2703,8902,4618,670,124,13520,10624.53
2016,31,NEW YORK,2,INDEPENDENT,1,PRIVATE,1,4-Year/Grad,472000,800000047858,TOURO COLLEGE,1691,1688,3,578,537,41,68,0,849,2101,2608,2679,119,100,5287,3641.07
2017,31,NEW YORK,2,INDEPENDENT,1,PRIVATE,1,4-Year/Grad,472000,800000047858,TOURO COLLEGE,1643,1643,0,538,474,64,55,0,690,1626,2388,2164,78,97,4552,3217.73
2018,31,NEW YORK,2,INDEPENDENT,1,PRIVATE,1,4-Year/Grad,472000,800000047858,TOURO COLLEGE,1801,1801,0,896,622,274,59,0,648,1580,2508,2476,172,104,4984,3438.67
2019,31,NEW YORK,2,INDEPENDENT,1,PRIVATE,1,4-Year/Grad,472000,800000047858,TOURO COLLEGE,1790,1790,0,807,536,271,63,0,654,1571,2507,2378,218,77,4885,3404.4
2016,58,SUFFOLK,2,INDEPENDENT,1,PRIVATE,1,4-Year/Grad,472010,800000037365,TOURO COLLEGE-CENTRAL ISLIP,0,0,0,0,0,0,309,149,1,9,310,158,0,0,468,373.2
2017,58,SUFFOLK,2,INDEPENDENT,1,PRIVATE,1,4-Year/Grad,472010,800000037365,TOURO COLLEGE-CENTRAL ISLIP,0,0,0,0,0,0,451,26,0,0,451,26,0,0,477,461.4
2018,58,SUFFOLK,2,INDEPENDENT,1,PRIVATE,1,4-Year/Grad,472010,800000037365,TOURO COLLEGE-CENTRAL ISLIP,0,0,0,0,0,0,468,20,9,2,477,22,0,0,499,485.8
2019,58,SUFFOLK,2,INDEPENDENT,1,PRIVATE,1,4-Year/Grad,472010,800000037365,TOURO COLLEGE-CENTRAL ISLIP,0,0,0,0,0,0,351,152,0,6,351,158,0,0,509,414.2
2016,33,KINGS,2,INDEPENDENT,1,PRIVATE,1,4-Year/Grad,472020,800000057567,TOURO COLLEGE - FLATBUSH,2025,2016,9,1007,889,118,0,0,325,540,2350,1547,175,134,3897,2901.67
2017,33,KINGS,2,INDEPENDENT,1,PRIVATE,1,4-Year/Grad,472020,800000057567,TOURO COLLEGE - FLATBUSH,2302,2298,4,971,851,120,0,0,198,537,2500,1508,136,79,4008,3038.47
2018,33,KINGS,2,INDEPENDENT,1,PRIVATE,1,4-Year/Grad,472020,800000057567,TOURO COLLEGE - FLATBUSH,1634,1622,12,1056,621,435,0,0,235,467,1869,1523,235,109,3392,2407.8
2019,33,KINGS,2,INDEPENDENT,1,PRIVATE,1,4-Year/Grad,472020,800000057567,TOURO COLLEGE - FLATBUSH,1553,1550,3,985,546,439,0,0,223,479,1776,1464,283,71,3240,2295.93
2016,58,SUFFOLK,2,INDEPENDENT,1,PRIVATE,1,4-Year/Grad,472030,800000065211,TOURO COLLEGE - BAYSHORE,229,229,0,61,56,5,92,30,207,162,528,253,9,1,781,625.13
2017,58,SUFFOLK,2,INDEPENDENT,1,PRIVATE,1,4-Year/Grad,472030,800000065211,TOURO COLLEGE - BAYSHORE,226,226,0,29,23,6,112,21,188,162,526,212,1,0,738,608.87
2018,58,SUFFOLK,2,INDEPENDENT,1,PRIVATE,1,4-Year/Grad,472030,800000065211,TOURO COLLEGE - BAYSHORE,176,176,0,20,20,0,133,23,196,165,505,208,0,0,713,586.87
2019,58,SUFFOLK,2,INDEPENDENT,1,PRIVATE,1,4-Year/Grad,472030,800000065211,TOURO COLLEGE - BAYSHORE,167,167,0,6,4,2,131,26,198,160,496,192,0,1,688,572.4
2016,34,QUEENS,2,INDEPENDENT,1,PRIVATE,1,4-Year/Grad,472040,800000065212,TOURO COLLEGE - KEW GARDENS,323,320,3,85,80,5,0,0,0,0,323,85,20,8,408,351.33
2017,34,QUEENS,2,INDEPENDENT,1,PRIVATE,1,4-Year/Grad,472040,800000065212,TOURO COLLEGE - KEW GARDENS,336,327,9,72,65,7,0,0,0,0,336,72,5,1,408,360
2018,34,QUEENS,2,INDEPENDENT,1,PRIVATE,1,4-Year/Grad,472040,800000065212,TOURO COLLEGE - KEW GARDENS,323,311,12,76,70,6,0,0,0,0,323,76,63,10,399,348.33
2019,34,QUEENS,2,INDEPENDENT,1,PRIVATE,1,4-Year/Grad,472040,800000065212,TOURO COLLEGE - KEW GARDENS,320,318,2,59,54,5,0,0,0,0,320,59,76,8,379,339.67
2016,31,NEW YORK,2,INDEPENDENT,1,PRIVATE,1,4-Year/Grad,472050,800000065213,TOURO COLLEGE - HARLEM,0,0,0,0,0,0,902,10,72,7,974,17,0,0,991,980.8
2017,31,NEW YORK,2,INDEPENDENT,1,PRIVATE,1,4-Year/Grad,472050,800000065213,TOURO COLLEGE - HARLEM,0,0,0,0,0,0,833,1,75,2,908,3,0,0,911,909.2
2018,31,NEW YORK,2,INDEPENDENT,1,PRIVATE,1,4-Year/Grad,472050,800000065213,TOURO COLLEGE - HARLEM,0,0,0,0,0,0,799,7,83,0,882,7,0,0,889,884.8
2019,31,NEW YORK,2,INDEPENDENT,1,PRIVATE,1,4-Year/Grad,472050,800000065213,TOURO COLLEGE - HARLEM,0,0,0,0,0,0,767,12,97,1,864,13,0,0,877,869.2
2016,44,ORANGE,2,INDEPENDENT,1,PRIVATE,1,4-Year/Grad,472060,800000085903,TOURO COLLEGE,0,0,0,0,0,0,396,4,74,12,470,16,0,0,486,476.4
2017,44,ORANGE,2,INDEPENDENT,1,PRIVATE,1,4-Year/Grad,472060,800000085903,TOURO COLLEGE,0,0,0,0,0,0,532,0,61,1,593,1,0,0,594,593.4
2018,44,ORANGE,2,INDEPENDENT,1,PRIVATE,1,4-Year/Grad,472060,800000085903,TOURO COLLEGE,0,0,0,0,0,0,543,0,55,2,598,2,0,0,600,598.8
2019,44,ORANGE,2,INDEPENDENT,1,PRIVATE,1,4-Year/Grad,472060,800000085903,TOURO COLLEGE,0,0,0,0,0,0,542,1,75,1,617,2,0,0,619,617.8
2016,66,WESTCHESTER,2,INDEPENDENT,1,PRIVATE,1,4-Year/Grad,472070,800000088205,TOURO COLLEGE - VALHALLA,0,0,0,0,0,0,0,0,2,8,2,8,0,0,10,5.2
2017,66,WESTCHESTER,2,INDEPENDENT,1,PRIVATE,1,4-Year/Grad,472070,800000088205,TOURO COLLEGE - VALHALLA,0,0,0,0,0,0,0,0,1,3,1,3,0,0,4,2.2
2018,66,WESTCHESTER,2,INDEPENDENT,1,PRIVATE,1,4-Year/Grad,472070,800000088205,TOURO COLLEGE - VALHALLA,0,0,0,0,0,0,323,1,0,0,323,1,0,0,324,323.4
2019,66,WESTCHESTER,2,INDEPENDENT,1,PRIVATE,1,4-Year/Grad,472070,800000088205,TOURO COLLEGE - VALHALLA,0,0,0,2,2,0,432,0,0,0,432,2,0,0,434,432.67
2010,14,ERIE,2,INDEPENDENT,1,PRIVATE,1,4-Year/Grad,472500,800000052474,TROCAIRE COLLEGE,752,749,3,819,578,241,0,0,0,0,752,819,146,26,1571,1025
2011,14,ERIE,2,INDEPENDENT,1,PRIVATE,1,4-Year/Grad,472500,800000052474,TROCAIRE COLLEGE,788,788,0,779,632,147,0,0,0,0,788,779,112,20,1567,1047.67
2012,14,ERIE,2,INDEPENDENT,1,PRIVATE,1,4-Year/Grad,472500,800000052474,TROCAIRE COLLEGE,690,690,0,833,716,117,0,0,0,0,690,833,125,29,1523,967.67
2013,14,ERIE,2,INDEPENDENT,1,PRIVATE,1,4-Year/Grad,472500,800000052474,TROCAIRE COLLEGE,675,675,0,817,709,108,0,0,0,0,675,817,122,27,1492,947.33
2014,14,ERIE,2,INDEPENDENT,1,PRIVATE,1,4-Year/Grad,472500,800000052474,TROCAIRE COLLEGE,671,670,1,796,666,130,0,0,0,0,671,796,128,10,1467,936.33
2015,14,ERIE,2,INDEPENDENT,1,PRIVATE,1,4-Year/Grad,472500,800000052474,TROCAIRE COLLEGE,621,612,9,748,618,130,0,0,0,0,621,748,110,7,1369,870.33
2016,14,ERIE,2,INDEPENDENT,1,PRIVATE,1,4-Year/Grad,472500,800000052474,TROCAIRE COLLEGE,618,612,6,816,672,144,0,0,0,0,618,816,124,20,1434,890
2017,14,ERIE,2,INDEPENDENT,1,PRIVATE,1,4-Year/Grad,472500,800000052474,TROCAIRE COLLEGE,593,593,0,806,686,120,0,0,0,0,593,806,99,10,1399,861.67
2018,14,ERIE,2,INDEPENDENT,1,PRIVATE,1,4-Year/Grad,472500,800000052474,TROCAIRE COLLEGE,589,589,0,760,624,136,0,0,0,0,589,760,81,7,1349,842.33
2019,14,ERIE,2,INDEPENDENT,1,PRIVATE,1,4-Year/Grad,472500,800000052474,TROCAIRE COLLEGE,451,448,3,871,739,132,0,0,0,0,451,871,62,18,1322,741.33
2010,13,DUTCHESS,2,INDEPENDENT,1,PRIVATE,1,4-Year/Grad,472800,800000053226,UNIFICATION THEOLOGICAL SEMINARY,0,0,0,0,0,0,18,14,61,11,79,25,0,0,104,89
2011,13,DUTCHESS,2,INDEPENDENT,1,PRIVATE,1,4-Year/Grad,472800,800000053226,UNIFICATION THEOLOGICAL SEMINARY,0,0,0,0,0,0,15,14,55,7,70,21,0,0,91,78.4
2012,13,DUTCHESS,2,INDEPENDENT,1,PRIVATE,1,4-Year/Grad,472800,800000053226,UNIFICATION THEOLOGICAL SEMINARY,0,0,0,0,0,0,15,12,48,18,63,30,0,0,93,75
2013,13,DUTCHESS,2,INDEPENDENT,1,PRIVATE,1,4-Year/Grad,472800,800000053226,UNIFICATION THEOLOGICAL SEMINARY,16,16,0,3,2,1,21,15,51,10,88,28,5,0,116,99
2014,13,DUTCHESS,2,INDEPENDENT,1,PRIVATE,1,4-Year/Grad,472800,800000053226,UNIFICATION THEOLOGICAL SEMINARY,29,28,1,8,4,4,10,10,53,12,92,30,11,1,122,103.47
2015,13,DUTCHESS,2,INDEPENDENT,1,PRIVATE,1,4-Year/Grad,472800,800000053226,UNIFICATION THEOLOGICAL SEMINARY,0,0,0,0,0,0,10,11,45,10,55,21,0,0,76,63.4
2016,13,DUTCHESS,2,INDEPENDENT,1,PRIVATE,1,4-Year/Grad,472800,800000053226,UNIFICATION THEOLOGICAL SEMINARY,0,0,0,0,0,0,7,11,54,10,61,21,0,0,82,69.4
2017,13,DUTCHESS,2,INDEPENDENT,1,PRIVATE,1,4-Year/Grad,472800,800000053226,UNIFICATION THEOLOGICAL SEMINARY,0,0,0,0,0,0,6,7,53,44,59,51,0,0,110,79.4
2018,13,DUTCHESS,2,INDEPENDENT,1,PRIVATE,1,4-Year/Grad,472800,800000053226,UNIFICATION THEOLOGICAL SEMINARY,0,0,0,0,0,0,5,5,41,38,46,43,0,0,89,63.2
2019,13,DUTCHESS,2,INDEPENDENT,1,PRIVATE,1,4-Year/Grad,472800,800000053226,UNIFICATION THEOLOGICAL SEMINARY,0,0,0,0,0,0,7,9,37,44,44,53,0,0,97,65.2
2010,53,SCHENECTADY,2,INDEPENDENT,1,PRIVATE,1,4-Year/Grad,473000,800000055826,UNION COLLEGE,2170,2150,20,27,9,18,0,0,0,0,2170,27,554,0,2197,2179
2011,53,SCHENECTADY,2,INDEPENDENT,1,PRIVATE,1,4-Year/Grad,473000,800000055826,UNION COLLEGE,2194,2170,24,26,4,22,0,0,0,0,2194,26,572,0,2220,2202.67
2012,53,SCHENECTADY,2,INDEPENDENT,1,PRIVATE,1,4-Year/Grad,473000,800000055826,UNION COLLEGE,2209,2183,26,32,9,23,0,0,0,0,2209,32,591,0,2241,2219.67
2013,53,SCHENECTADY,2,INDEPENDENT,1,PRIVATE,1,4-Year/Grad,473000,800000055826,UNION COLLEGE,2225,2202,23,21,4,17,0,0,0,0,2225,21,559,0,2246,2232
2014,53,SCHENECTADY,2,INDEPENDENT,1,PRIVATE,1,4-Year/Grad,473000,800000055826,UNION COLLEGE,2228,2202,26,14,2,12,0,0,0,0,2228,14,570,0,2242,2232.67
2015,53,SCHENECTADY,2,INDEPENDENT,1,PRIVATE,1,4-Year/Grad,473000,800000055826,UNION COLLEGE,2226,2200,26,43,6,37,0,0,0,0,2226,43,568,0,2269,2240.33
2016,53,SCHENECTADY,2,INDEPENDENT,1,PRIVATE,1,4-Year/Grad,473000,800000055826,UNION COLLEGE,2132,2114,18,71,5,66,0,0,0,0,2132,71,560,0,2203,2155.67
2017,53,SCHENECTADY,2,INDEPENDENT,1,PRIVATE,1,4-Year/Grad,473000,800000055826,UNION COLLEGE,2176,2163,13,91,0,91,0,0,0,0,2176,91,570,0,2267,2206.33
2018,53,SCHENECTADY,2,INDEPENDENT,1,PRIVATE,1,4-Year/Grad,473000,800000055826,UNION COLLEGE,2178,2178,0,4,2,2,0,0,0,0,2178,4,571,0,2182,2179.33
2019,53,SCHENECTADY,2,INDEPENDENT,1,PRIVATE,1,4-Year/Grad,473000,800000055826,UNION COLLEGE,2173,2157,16,16,4,12,0,0,0,0,2173,16,550,0,2189,2178.33
2010,31,NEW YORK,2,INDEPENDENT,1,PRIVATE,1,4-Year/Grad,473500,800000047067,UNION THEOLOGICAL SEMINARY,0,0,0,0,0,0,154,12,47,46,201,58,0,0,259,224.2
2011,31,NEW YORK,2,INDEPENDENT,1,PRIVATE,1,4-Year/Grad,473500,800000047067,UNION THEOLOGICAL SEMINARY,0,0,0,0,0,0,138,10,42,55,180,65,0,0,245,206
2012,31,NEW YORK,2,INDEPENDENT,1,PRIVATE,1,4-Year/Grad,473500,800000047067,UNION THEOLOGICAL SEMINARY,0,0,0,0,0,0,135,7,52,54,187,61,0,0,248,211.4
2013,31,NEW YORK,2,INDEPENDENT,1,PRIVATE,1,4-Year/Grad,473500,800000047067,UNION THEOLOGICAL SEMINARY,0,0,0,0,0,0,127,7,84,20,211,27,0,0,238,221.8
2014,31,NEW YORK,2,INDEPENDENT,1,PRIVATE,1,4-Year/Grad,473500,800000047067,UNION THEOLOGICAL SEMINARY,0,0,0,0,0,0,130,6,79,15,209,21,0,0,230,217.4
2015,31,NEW YORK,2,INDEPENDENT,1,PRIVATE,1,4-Year/Grad,473500,800000047067,UNION THEOLOGICAL SEMINARY,0,0,0,0,0,0,126,7,83,9,209,16,0,0,225,215.4
2010,26,MONROE,2,INDEPENDENT,1,PRIVATE,1,4-Year/Grad,474000,800000050274,UNIVERSITY OF ROCHESTER,5330,5319,11,271,113,158,429,0,2761,1320,8520,1591,1308,1,10111,9138.33
2011,26,MONROE,2,INDEPENDENT,1,PRIVATE,1,4-Year/Grad,474000,800000050274,UNIVERSITY OF ROCHESTER,5373,5358,15,270,113,157,432,0,2792,1423,8597,1693,1273,0,10290,9256.2
2012,26,MONROE,2,INDEPENDENT,1,PRIVATE,1,4-Year/Grad,474000,800000050274,UNIVERSITY OF ROCHESTER,5512,5495,17,273,128,145,430,0,2842,1453,8784,1726,1343,0,10510,9456.2
2013,26,MONROE,2,INDEPENDENT,1,PRIVATE,1,4-Year/Grad,474000,800000050274,UNIVERSITY OF ROCHESTER,5837,5819,18,340,228,112,431,0,3016,1396,9284,1736,1472,0,11020,9955.73
2014,26,MONROE,2,INDEPENDENT,1,PRIVATE,1,4-Year/Grad,474000,800000050274,UNIVERSITY OF ROCHESTER,5942,5926,16,324,164,160,432,0,3062,1300,9436,1624,1436,0,11060,10064
2015,26,MONROE,2,INDEPENDENT,1,PRIVATE,1,4-Year/Grad,474000,800000050274,UNIVERSITY OF ROCHESTER,6046,6011,35,258,112,146,432,0,2992,1377,9470,1635,1400,0,11105,10106.8
2016,26,MONROE,2,INDEPENDENT,1,PRIVATE,1,4-Year/Grad,474000,800000050274,UNIVERSITY OF ROCHESTER,6170,6138,32,216,97,119,430,0,2994,1399,9594,1615,1461,0,11209,10225.6
2017,26,MONROE,2,INDEPENDENT,1,PRIVATE,1,4-Year/Grad,474000,800000050274,UNIVERSITY OF ROCHESTER,6250,6227,23,296,93,203,424,0,3092,1586,9766,1882,1550,0,11648,10499.07
2018,26,MONROE,2,INDEPENDENT,1,PRIVATE,1,4-Year/Grad,474000,800000050274,UNIVERSITY OF ROCHESTER,6293,6274,19,242,87,155,423,0,3221,1638,9937,1880,1522,0,11817,10672.87
2019,26,MONROE,2,INDEPENDENT,1,PRIVATE,1,4-Year/Grad,474000,800000050274,UNIVERSITY OF ROCHESTER,6410,6371,39,370,150,220,423,0,3227,1803,10060,2173,1500,0,12233,10904.53
2010,41,ONEIDA,2,INDEPENDENT,1,PRIVATE,1,4-Year/Grad,474300,800000041204,UTICA COLLEGE,2037,2027,10,561,561,0,78,190,128,523,2243,1274,526,0,3517,2715.2
2011,41,ONEIDA,2,INDEPENDENT,1,PRIVATE,1,4-Year/Grad,474300,800000041204,UTICA COLLEGE,2120,2105,15,566,510,56,37,300,161,488,2318,1354,545,35,3672,2821.87
2012,41,ONEIDA,2,INDEPENDENT,1,PRIVATE,1,4-Year/Grad,474300,800000041204,UTICA COLLEGE,2113,2099,14,637,578,59,48,309,156,555,2317,1501,517,38,3818,2874.93
2013,41,ONEIDA,2,INDEPENDENT,1,PRIVATE,1,4-Year/Grad,474300,800000041204,UTICA COLLEGE,2226,2208,18,638,606,32,131,231,213,934,2570,1803,500,29,4373,3248.67
2014,41,ONEIDA,2,INDEPENDENT,1,PRIVATE,1,4-Year/Grad,474300,800000041204,UTICA COLLEGE,2225,2204,21,701,653,48,156,268,143,743,2524,1712,492,31,4236,3162.07
2015,41,ONEIDA,2,INDEPENDENT,1,PRIVATE,1,4-Year/Grad,474300,800000041204,UTICA COLLEGE,2337,2332,5,671,633,38,199,271,147,762,2683,1704,650,38,4387,3319.87
2016,41,ONEIDA,2,INDEPENDENT,1,PRIVATE,1,4-Year/Grad,474300,800000041204,UTICA COLLEGE,2701,2673,28,825,738,87,195,299,890,167,3786,1291,702,40,5077,4247.4
2017,41,ONEIDA,2,INDEPENDENT,1,PRIVATE,1,4-Year/Grad,474300,800000041204,UTICA COLLEGE,2855,2846,9,799,719,80,161,309,831,238,3847,1346,555,34,5193,4332.13
2018,41,ONEIDA,2,INDEPENDENT,1,PRIVATE,1,4-Year/Grad,474300,800000041204,UTICA COLLEGE,2909,2900,9,813,702,111,123,216,860,262,3892,1291,587,1,5183,4354.2
2019,41,ONEIDA,2,INDEPENDENT,1,PRIVATE,1,4-Year/Grad,474300,800000041204,UTICA COLLEGE,2765,2751,14,680,587,93,126,143,879,281,3770,1104,512,53,4874,4166.27
2010,13,DUTCHESS,2,INDEPENDENT,1,PRIVATE,1,4-Year/Grad,474500,800000053306,VASSAR COLLEGE,2401,2392,9,45,16,29,0,0,0,0,2401,45,666,1,2446,2416
2011,13,DUTCHESS,2,INDEPENDENT,1,PRIVATE,1,4-Year/Grad,474500,800000053306,VASSAR COLLEGE,2345,2331,14,41,14,27,0,0,0,0,2345,41,669,5,2386,2358.67
2012,13,DUTCHESS,2,INDEPENDENT,1,PRIVATE,1,4-Year/Grad,474500,800000053306,VASSAR COLLEGE,2370,2354,16,36,16,20,0,0,0,0,2370,36,657,1,2406,2382
2013,13,DUTCHESS,2,INDEPENDENT,1,PRIVATE,1,4-Year/Grad,474500,800000053306,VASSAR COLLEGE,2437,2422,15,40,14,26,0,0,0,0,2437,40,666,0,2477,2450.33
2014,13,DUTCHESS,2,INDEPENDENT,1,PRIVATE,1,4-Year/Grad,474500,800000053306,VASSAR COLLEGE,2394,2377,17,24,9,15,0,0,0,0,2394,24,662,1,2418,2402
2015,13,DUTCHESS,2,INDEPENDENT,1,PRIVATE,1,4-Year/Grad,474500,800000053306,VASSAR COLLEGE,2421,2407,14,14,7,7,0,0,0,0,2421,14,667,0,2435,2425.67
2016,13,DUTCHESS,2,INDEPENDENT,1,PRIVATE,1,4-Year/Grad,474500,800000053306,VASSAR COLLEGE,2405,2390,15,19,10,9,0,0,0,0,2405,19,658,1,2424,2411.33
2017,13,DUTCHESS,2,INDEPENDENT,1,PRIVATE,1,4-Year/Grad,474500,800000053306,VASSAR COLLEGE,2334,2317,17,19,6,13,0,0,0,0,2334,19,624,0,2353,2340.33
2018,13,DUTCHESS,2,INDEPENDENT,1,PRIVATE,1,4-Year/Grad,474500,800000053306,VASSAR COLLEGE,2442,2432,10,14,4,10,0,0,0,0,2442,14,685,0,2456,2446.67
2019,13,DUTCHESS,2,INDEPENDENT,1,PRIVATE,1,4-Year/Grad,474500,800000053306,VASSAR COLLEGE,2417,2417,0,4,4,0,0,0,0,0,2417,4,689,1,2421,2418.33
2010,14,ERIE,2,INDEPENDENT,1,PRIVATE,1,4-Year/Grad,475500,800000052475,VILLA MARIA COLLEGE OF BUFFALO,399,399,0,108,94,14,0,0,0,0,399,108,110,4,507,435
2011,14,ERIE,2,INDEPENDENT,1,PRIVATE,1,4-Year/Grad,475500,800000052475,VILLA MARIA COLLEGE OF BUFFALO,372,372,0,85,79,6,0,0,0,0,372,85,84,8,457,400.33
2012,14,ERIE,2,INDEPENDENT,1,PRIVATE,1,4-Year/Grad,475500,800000052475,VILLA MARIA COLLEGE OF BUFFALO,319,319,0,92,89,3,0,0,0,0,319,92,70,5,411,349.67
2013,14,ERIE,2,INDEPENDENT,1,PRIVATE,1,4-Year/Grad,475500,800000052475,VILLA MARIA COLLEGE OF BUFFALO,356,356,0,109,100,9,0,0,0,0,356,109,120,10,465,392.33
2014,14,ERIE,2,INDEPENDENT,1,PRIVATE,1,4-Year/Grad,475500,800000052475,VILLA MARIA COLLEGE OF BUFFALO,361,361,0,116,108,8,0,0,0,0,361,116,105,8,477,399.67
2015,14,ERIE,2,INDEPENDENT,1,PRIVATE,1,4-Year/Grad,475500,800000052475,VILLA MARIA COLLEGE OF BUFFALO,418,418,0,147,123,24,0,0,0,0,418,147,134,4,565,467
2016,14,ERIE,2,INDEPENDENT,1,PRIVATE,1,4-Year/Grad,475500,800000052475,VILLA MARIA COLLEGE OF BUFFALO,470,470,0,119,114,5,0,0,0,0,470,119,145,7,589,509.67
2017,14,ERIE,2,INDEPENDENT,1,PRIVATE,1,4-Year/Grad,475500,800000052475,VILLA MARIA COLLEGE OF BUFFALO,490,490,0,106,101,5,0,0,0,0,490,106,129,5,596,525.33
2018,14,ERIE,2,INDEPENDENT,1,PRIVATE,1,4-Year/Grad,475500,800000052475,VILLA MARIA COLLEGE OF BUFFALO,440,440,0,104,98,6,0,0,0,0,440,104,126,5,544,474.67
2019,14,ERIE,2,INDEPENDENT,1,PRIVATE,1,4-Year/Grad,475500,800000052475,VILLA MARIA COLLEGE OF BUFFALO,450,450,0,70,66,4,0,0,0,0,450,70,130,4,520,473.33
2010,35,RICHMOND,2,INDEPENDENT,1,PRIVATE,1,4-Year/Grad,477000,800000033972,WAGNER COLLEGE,1740,1739,1,99,86,13,0,0,232,200,1972,299,483,0,2271,2085
2011,35,RICHMOND,2,INDEPENDENT,1,PRIVATE,1,4-Year/Grad,477000,800000033972,WAGNER COLLEGE,1760,1760,0,96,81,15,0,0,202,175,1962,271,470,0,2233,2064
2012,35,RICHMOND,2,INDEPENDENT,1,PRIVATE,1,4-Year/Grad,477000,800000033972,WAGNER COLLEGE,1747,1744,3,81,79,2,0,0,212,181,1959,262,426,0,2221,2058.4
2013,35,RICHMOND,2,INDEPENDENT,1,PRIVATE,1,4-Year/Grad,477000,800000033972,WAGNER COLLEGE,1765,1764,1,77,66,11,0,0,220,183,1985,260,430,0,2245,2083.87
2014,35,RICHMOND,2,INDEPENDENT,1,PRIVATE,1,4-Year/Grad,477000,800000033972,WAGNER COLLEGE,1761,1761,0,62,53,9,0,13,202,193,1963,268,441,1,2231,2066.07
2015,35,RICHMOND,2,INDEPENDENT,1,PRIVATE,1,4-Year/Grad,477000,800000033972,WAGNER COLLEGE,1715,1714,1,41,34,7,0,22,204,232,1919,295,415,0,2214,2034.27
2016,35,RICHMOND,2,INDEPENDENT,1,PRIVATE,1,4-Year/Grad,477000,800000033972,WAGNER COLLEGE,1768,1762,6,39,34,5,0,0,200,294,1968,333,441,1,2301,2098.6
2017,35,RICHMOND,2,INDEPENDENT,1,PRIVATE,1,4-Year/Grad,477000,800000033972,WAGNER COLLEGE,1747,1743,4,65,49,16,3,33,228,212,1978,310,432,1,2288,2097.67
2018,35,RICHMOND,2,INDEPENDENT,1,PRIVATE,1,4-Year/Grad,477000,800000033972,WAGNER COLLEGE,1718,1718,0,34,34,0,1,30,186,232,1905,296,422,2,2201,2021.13
2019,35,RICHMOND,2,INDEPENDENT,1,PRIVATE,1,4-Year/Grad,477000,800000033972,WAGNER COLLEGE,1675,1667,8,65,54,11,0,26,157,231,1832,322,410,0,2154,1956.47
2010,28,NASSAU,2,INDEPENDENT,1,PRIVATE,1,4-Year/Grad,477500,800000049881,WEBB INSTITUTE,80,80,0,0,0,0,0,0,0,0,80,0,18,0,80,80
2011,28,NASSAU,2,INDEPENDENT,1,PRIVATE,1,4-Year/Grad,477500,800000049881,WEBB INSTITUTE,81,81,0,0,0,0,0,0,0,0,81,0,22,0,81,81
2012,28,NASSAU,2,INDEPENDENT,1,PRIVATE,1,4-Year/Grad,477500,800000049881,WEBB INSTITUTE,79,79,0,0,0,0,0,0,0,0,79,0,22,0,79,79
2013,28,NASSAU,2,INDEPENDENT,1,PRIVATE,1,4-Year/Grad,477500,800000049881,WEBB INSTITUTE,82,82,0,0,0,0,0,0,0,0,82,0,26,0,82,82
2014,28,NASSAU,2,INDEPENDENT,1,PRIVATE,1,4-Year/Grad,477500,800000049881,WEBB INSTITUTE,90,90,0,0,0,0,0,0,0,0,90,0,24,0,90,90
2015,28,NASSAU,2,INDEPENDENT,1,PRIVATE,1,4-Year/Grad,477500,800000049881,WEBB INSTITUTE,91,91,0,0,0,0,0,0,0,0,91,0,26,0,91,91
2016,28,NASSAU,2,INDEPENDENT,1,PRIVATE,1,4-Year/Grad,477500,800000049881,WEBB INSTITUTE,92,92,0,0,0,0,0,0,0,0,92,0,28,0,92,92
2017,28,NASSAU,2,INDEPENDENT,1,PRIVATE,1,4-Year/Grad,477500,800000049881,WEBB INSTITUTE,98,98,0,0,0,0,0,0,0,0,98,0,26,0,98,98
2018,28,NASSAU,2,INDEPENDENT,1,PRIVATE,1,4-Year/Grad,477500,800000049881,WEBB INSTITUTE,104,104,0,0,0,0,0,0,0,0,104,0,25,0,104,104
2019,28,NASSAU,2,INDEPENDENT,1,PRIVATE,1,4-Year/Grad,477500,800000049881,WEBB INSTITUTE,102,102,0,0,0,0,0,0,0,0,102,0,26,0,102,102
2010,05,CAYUGA,2,INDEPENDENT,1,PRIVATE,1,4-Year/Grad,478000,800000054494,WELLS COLLEGE,550,545,5,9,6,3,0,0,0,0,550,9,164,0,559,553
2011,05,CAYUGA,2,INDEPENDENT,1,PRIVATE,1,4-Year/Grad,478000,800000054494,WELLS COLLEGE,487,481,6,10,2,8,0,0,0,0,487,10,137,0,497,490.33
2012,05,CAYUGA,2,INDEPENDENT,1,PRIVATE,1,4-Year/Grad,478000,800000054494,WELLS COLLEGE,523,518,5,9,6,3,0,0,0,0,523,9,197,0,532,526
2013,05,CAYUGA,2,INDEPENDENT,1,PRIVATE,1,4-Year/Grad,478000,800000054494,WELLS COLLEGE,524,518,6,10,8,2,0,0,0,0,524,10,161,0,534,527.33
2014,05,CAYUGA,2,INDEPENDENT,1,PRIVATE,1,4-Year/Grad,478000,800000054494,WELLS COLLEGE,524,519,5,26,6,20,0,0,0,0,524,26,163,0,550,532.67
2015,05,CAYUGA,2,INDEPENDENT,1,PRIVATE,1,4-Year/Grad,478000,800000054494,WELLS COLLEGE,558,553,5,14,10,4,0,0,0,0,558,14,168,1,572,562.67
2016,05,CAYUGA,2,INDEPENDENT,1,PRIVATE,1,4-Year/Grad,478000,800000054494,WELLS COLLEGE,509,504,5,6,2,4,0,0,0,0,509,6,132,0,515,511
2017,05,CAYUGA,2,INDEPENDENT,1,PRIVATE,1,4-Year/Grad,478000,800000054494,WELLS COLLEGE,481,476,5,2,1,1,0,0,0,0,481,2,137,0,483,481.67
2018,05,CAYUGA,2,INDEPENDENT,1,PRIVATE,1,4-Year/Grad,478000,800000054494,WELLS COLLEGE,462,458,4,5,3,2,0,0,0,0,462,5,147,0,467,463.67
2019,05,CAYUGA,2,INDEPENDENT,1,PRIVATE,1,4-Year/Grad,478000,800000054494,WELLS COLLEGE,414,410,4,5,3,2,0,0,0,0,414,5,132,0,419,415.67
2010,31,NEW YORK,2,INDEPENDENT,1,PRIVATE,1,4-Year/Grad,479000,800000046923,YESHIVA UNIVERSITY,2770,2770,0,62,62,0,2152,4,980,476,5902,542,888,6,6444,6114.67
2011,31,NEW YORK,2,INDEPENDENT,1,PRIVATE,1,4-Year/Grad,479000,800000046923,YESHIVA UNIVERSITY,2705,2705,0,82,82,0,1838,351,1026,515,5569,948,892,6,6517,5942.73
2012,31,NEW YORK,2,INDEPENDENT,1,PRIVATE,1,4-Year/Grad,479000,800000046923,YESHIVA UNIVERSITY,2759,2759,0,103,103,0,1889,463,1027,500,5675,1066,907,11,6741,6094.53
2013,31,NEW YORK,2,INDEPENDENT,1,PRIVATE,1,4-Year/Grad,479000,800000046923,YESHIVA UNIVERSITY,2782,2782,0,105,105,0,1813,549,976,510,5571,1164,866,3,6735,6029.6
2014,31,NEW YORK,2,INDEPENDENT,1,PRIVATE,1,4-Year/Grad,479000,800000046923,YESHIVA UNIVERSITY,2725,2725,0,89,89,0,1772,520,899,430,5396,1039,812,0,6435,5805.67
2015,31,NEW YORK,2,INDEPENDENT,1,PRIVATE,1,4-Year/Grad,479000,800000046923,YESHIVA UNIVERSITY,2643,2643,0,97,69,28,1635,504,911,407,5189,1008,539,16,6197,5585.73
2016,31,NEW YORK,2,INDEPENDENT,1,PRIVATE,1,4-Year/Grad,479000,800000046923,YESHIVA UNIVERSITY,1984,1984,0,86,50,36,1565,582,897,410,4446,1078,535,6,5524,4871.47
2017,31,NEW YORK,2,INDEPENDENT,1,PRIVATE,1,4-Year/Grad,479000,800000046923,YESHIVA UNIVERSITY,2044,2044,0,88,57,31,1598,601,981,393,4623,1082,610,9,5705,5049.93
2018,31,NEW YORK,2,INDEPENDENT,1,PRIVATE,1,4-Year/Grad,479000,800000046923,YESHIVA UNIVERSITY,2011,2011,0,95,49,46,1669,579,1077,426,4757,1100,553,8,5857,5190.67
2019,31,NEW YORK,2,INDEPENDENT,1,PRIVATE,1,4-Year/Grad,479000,800000046923,YESHIVA UNIVERSITY,1971,1971,0,186,69,117,931,70,1076,451,3978,707,550,9,4685,4248.4
2010,33,KINGS,3,PROPRIETARY,1,PRIVATE,0,2-Year,500700,800000045471,"ASA COLLEGE, INC.",5578,5577,1,226,220,6,0,0,0,0,5578,226,2018,34,5804,5653.33
2011,33,KINGS,3,PROPRIETARY,1,PRIVATE,0,2-Year,500700,800000045471,"ASA COLLEGE, INC.",4802,4799,3,270,240,30,0,0,0,0,4802,270,1257,40,5072,4892
2012,33,KINGS,3,PROPRIETARY,1,PRIVATE,0,2-Year,500700,800000045471,"ASA COLLEGE, INC.",4350,4350,0,341,338,3,0,0,0,0,4350,341,1538,45,4691,4463.67
2013,33,KINGS,3,PROPRIETARY,1,PRIVATE,0,2-Year,500700,800000045471,"ASA COLLEGE, INC.",4374,4355,19,338,303,35,0,0,0,0,4374,338,1371,50,4712,4486.67
2014,33,KINGS,3,PROPRIETARY,1,PRIVATE,0,2-Year,500700,800000045471,"ASA COLLEGE, INC.",3814,3794,20,335,285,50,0,0,0,0,3814,335,1054,40,4149,3925.67
2015,33,KINGS,3,PROPRIETARY,1,PRIVATE,0,2-Year,500700,800000045471,"ASA COLLEGE, INC.",3594,3590,4,376,344,32,0,0,0,0,3594,376,1106,27,3970,3719.33
2016,33,KINGS,3,PROPRIETARY,1,PRIVATE,0,2-Year,500700,800000045471,"ASA COLLEGE, INC.",3473,3470,3,343,321,22,0,0,0,0,3473,343,873,70,3816,3587.33
2017,33,KINGS,3,PROPRIETARY,1,PRIVATE,0,2-Year,500700,800000045471,"ASA COLLEGE, INC.",3497,3495,2,440,430,10,0,0,0,0,3497,440,1062,67,3937,3643.67
2018,33,KINGS,3,PROPRIETARY,1,PRIVATE,0,2-Year,500700,800000045471,"ASA COLLEGE, INC.",3144,3141,3,590,582,8,0,0,0,0,3144,590,861,76,3734,3340.67
2010,01,ALBANY,3,PROPRIETARY,1,PRIVATE,1,4-Year/Grad,501000,800000055591,BRYANT & STRATTON COLLEGE - ALBANY,582,582,0,263,262,1,0,0,0,0,582,263,159,3,845,669.67
2011,01,ALBANY,3,PROPRIETARY,1,PRIVATE,1,4-Year/Grad,501000,800000055591,BRYANT & STRATTON COLLEGE - ALBANY,482,482,0,287,287,0,0,0,0,0,482,287,104,2,769,577.67
2012,01,ALBANY,3,PROPRIETARY,1,PRIVATE,1,4-Year/Grad,501000,800000055591,BRYANT & STRATTON COLLEGE - ALBANY,437,436,1,288,270,18,0,0,0,0,437,288,119,2,725,533
2013,01,ALBANY,3,PROPRIETARY,1,PRIVATE,1,4-Year/Grad,501000,800000055591,BRYANT & STRATTON COLLEGE - ALBANY,346,346,0,235,223,12,0,0,0,0,346,235,78,2,581,424.33
2014,01,ALBANY,3,PROPRIETARY,1,PRIVATE,1,4-Year/Grad,501000,800000055591,BRYANT & STRATTON COLLEGE - ALBANY,284,284,0,214,194,20,0,0,0,0,284,214,60,1,498,355.33
2015,01,ALBANY,3,PROPRIETARY,1,PRIVATE,1,4-Year/Grad,501000,800000055591,BRYANT & STRATTON COLLEGE - ALBANY,288,288,0,141,130,11,0,0,0,0,288,141,65,4,429,335
2016,01,ALBANY,3,PROPRIETARY,1,PRIVATE,1,4-Year/Grad,501000,800000055591,BRYANT & STRATTON COLLEGE - ALBANY,256,256,0,172,164,8,0,0,0,0,256,172,30,0,428,313.33
2017,01,ALBANY,3,PROPRIETARY,1,PRIVATE,1,4-Year/Grad,501000,800000055591,BRYANT & STRATTON COLLEGE - ALBANY,225,225,0,119,108,11,0,0,0,0,225,119,34,0,344,264.67
2018,01,ALBANY,3,PROPRIETARY,1,PRIVATE,1,4-Year/Grad,501000,800000055591,BRYANT & STRATTON COLLEGE - ALBANY,252,252,0,111,111,0,0,0,0,0,252,111,41,5,363,289
2019,01,ALBANY,3,PROPRIETARY,1,PRIVATE,1,4-Year/Grad,501000,800000055591,BRYANT & STRATTON COLLEGE - ALBANY,274,274,0,93,92,1,0,0,0,0,274,93,49,0,367,305
2010,31,NEW YORK,3,PROPRIETARY,1,PRIVATE,1,4-Year/Grad,502000,800000047882,BERKELEY COLLEGE - MAIN CAMPUS,4537,4505,32,665,654,11,0,0,0,0,4537,665,813,65,5202,4758.67
2011,31,NEW YORK,3,PROPRIETARY,1,PRIVATE,1,4-Year/Grad,502000,800000047882,BERKELEY COLLEGE - MAIN CAMPUS,4674,4641,33,684,662,22,0,0,0,0,4674,684,995,34,5358,4902
2012,31,NEW YORK,3,PROPRIETARY,1,PRIVATE,1,4-Year/Grad,502000,800000047882,BERKELEY COLLEGE - MAIN CAMPUS,4246,4190,56,618,590,28,0,0,0,0,4246,618,606,44,4864,4452
2013,31,NEW YORK,3,PROPRIETARY,1,PRIVATE,1,4-Year/Grad,502000,800000047882,BERKELEY COLLEGE - MAIN CAMPUS,4058,4000,58,538,525,13,0,0,0,0,4058,538,729,43,4596,4237.33
2014,31,NEW YORK,3,PROPRIETARY,1,PRIVATE,1,4-Year/Grad,502000,800000047882,BERKELEY COLLEGE - MAIN CAMPUS,3929,3886,43,538,511,27,0,0,0,0,3929,538,669,32,4467,4108.33
2015,31,NEW YORK,3,PROPRIETARY,1,PRIVATE,1,4-Year/Grad,502000,800000047882,BERKELEY COLLEGE - MAIN CAMPUS,3910,3883,27,535,527,8,0,0,0,0,3910,535,539,33,4445,4088.33
2016,31,NEW YORK,3,PROPRIETARY,1,PRIVATE,1,4-Year/Grad,502000,800000047882,BERKELEY COLLEGE - MAIN CAMPUS,2737,2710,27,646,638,8,0,0,0,0,2737,646,334,66,3383,2952.33
2017,31,NEW YORK,3,PROPRIETARY,1,PRIVATE,1,4-Year/Grad,502000,800000047882,BERKELEY COLLEGE - MAIN CAMPUS,2144,2125,19,650,643,7,0,0,0,0,2144,650,224,26,2794,2360.67
2018,31,NEW YORK,3,PROPRIETARY,1,PRIVATE,1,4-Year/Grad,502000,800000047882,BERKELEY COLLEGE - MAIN CAMPUS,2019,1991,28,598,592,6,0,0,0,0,2019,598,291,41,2617,2218.33
2019,31,NEW YORK,3,PROPRIETARY,1,PRIVATE,1,4-Year/Grad,502000,800000047882,BERKELEY COLLEGE - MAIN CAMPUS,1817,1796,21,686,685,1,0,0,0,0,1817,686,165,21,2503,2045.67
2016,66,WESTCHESTER,3,PROPRIETARY,1,PRIVATE,1,4-Year/Grad,502020,800000034813,BERKELEY COLLEGE - WESTCHESTER,377,375,2,63,63,0,0,0,0,0,377,63,89,4,440,398
2017,66,WESTCHESTER,3,PROPRIETARY,1,PRIVATE,1,4-Year/Grad,502020,800000034813,BERKELEY COLLEGE - WESTCHESTER,343,343,0,51,50,1,0,0,0,0,343,51,78,1,394,360
2018,66,WESTCHESTER,3,PROPRIETARY,1,PRIVATE,1,4-Year/Grad,502020,800000034813,BERKELEY COLLEGE - WESTCHESTER,360,357,3,44,44,0,0,0,0,0,360,44,100,0,404,374.67
2019,66,WESTCHESTER,3,PROPRIETARY,1,PRIVATE,1,4-Year/Grad,502020,800000034813,BERKELEY COLLEGE - WESTCHESTER,284,284,0,47,46,1,0,0,0,0,284,47,48,0,331,299.67
2016,33,KINGS,3,PROPRIETARY,1,PRIVATE,1,4-Year/Grad,502030,800000070271,BERKELEY COLLEGE - BROOKLYN CAMPUS,307,307,0,146,145,1,0,0,0,0,307,146,52,17,453,355.67
2017,33,KINGS,3,PROPRIETARY,1,PRIVATE,1,4-Year/Grad,502030,800000070271,BERKELEY COLLEGE - BROOKLYN CAMPUS,272,272,0,175,175,0,0,0,0,0,272,175,34,15,447,330.33
2018,33,KINGS,3,PROPRIETARY,1,PRIVATE,1,4-Year/Grad,502030,800000070271,BERKELEY COLLEGE - BROOKLYN CAMPUS,333,333,0,190,190,0,0,0,0,0,333,190,53,13,523,396.33
2010,28,NASSAU,3,PROPRIETARY,1,PRIVATE,1,4-Year/Grad,502800,800000048939,BRIARCLIFFE COLLEGE,1634,1634,0,322,318,4,0,0,0,0,1634,322,396,23,1956,1741.33
2011,28,NASSAU,3,PROPRIETARY,1,PRIVATE,1,4-Year/Grad,502800,800000048939,BRIARCLIFFE COLLEGE,1387,1387,0,591,591,0,0,0,0,0,1387,591,302,108,1978,1584
2012,28,NASSAU,3,PROPRIETARY,1,PRIVATE,1,4-Year/Grad,502800,800000048939,BRIARCLIFFE COLLEGE,1629,1629,0,357,357,0,0,0,0,0,1629,357,293,29,1986,1748
2013,28,NASSAU,3,PROPRIETARY,1,PRIVATE,1,4-Year/Grad,502800,800000048939,BRIARCLIFFE COLLEGE,1460,1460,0,427,426,1,0,0,0,0,1460,427,214,18,1887,1602.33
2014,28,NASSAU,3,PROPRIETARY,1,PRIVATE,1,4-Year/Grad,502800,800000048939,BRIARCLIFFE COLLEGE,1358,1358,0,361,361,0,0,0,0,0,1358,361,154,15,1719,1478.33
2015,28,NASSAU,3,PROPRIETARY,1,PRIVATE,1,4-Year/Grad,502800,800000048939,BRIARCLIFFE COLLEGE,2056,2056,0,654,654,0,0,0,0,0,2056,654,192,32,2710,2274
2016,28,NASSAU,3,PROPRIETARY,1,PRIVATE,1,4-Year/Grad,502800,800000048939,BRIARCLIFFE COLLEGE,220,220,0,93,92,1,0,0,0,0,220,93,0,0,313,251
2017,28,NASSAU,3,PROPRIETARY,1,PRIVATE,1,4-Year/Grad,502800,800000048939,BRIARCLIFFE COLLEGE,47,47,0,34,34,0,0,0,0,0,47,34,0,0,81,58.33
2016,58,SUFFOLK,3,PROPRIETARY,1,PRIVATE,1,4-Year/Grad,502850,800000037515,BRIARCLIFFE COLLEGE - PATCHOGUE CAMPUS,169,169,0,38,38,0,0,0,0,0,169,38,0,0,207,181.67
2017,58,SUFFOLK,3,PROPRIETARY,1,PRIVATE,1,4-Year/Grad,502850,800000037515,BRIARCLIFFE COLLEGE - PATCHOGUE CAMPUS,17,17,0,10,10,0,0,0,0,0,17,10,0,0,27,20.33
2010,14,ERIE,3,PROPRIETARY,1,PRIVATE,1,4-Year/Grad,503000,800000052562,BRYANT & STRATTON COLLEGE - BUFFALO,646,646,0,310,297,13,0,0,0,0,646,310,259,24,956,749.33
2011,14,ERIE,3,PROPRIETARY,1,PRIVATE,1,4-Year/Grad,503000,800000052562,BRYANT & STRATTON COLLEGE - BUFFALO,587,587,0,287,267,20,0,0,0,0,587,287,245,27,874,682.67
2012,14,ERIE,3,PROPRIETARY,1,PRIVATE,1,4-Year/Grad,503000,800000052562,BRYANT & STRATTON COLLEGE - BUFFALO,578,578,0,295,285,10,0,0,0,0,578,295,122,16,873,676.33
2013,14,ERIE,3,PROPRIETARY,1,PRIVATE,1,4-Year/Grad,503000,800000052562,BRYANT & STRATTON COLLEGE - BUFFALO,453,453,0,286,263,23,0,0,0,0,453,286,85,12,739,548.33
2014,14,ERIE,3,PROPRIETARY,1,PRIVATE,1,4-Year/Grad,503000,800000052562,BRYANT & STRATTON COLLEGE - BUFFALO,428,428,0,372,243,129,0,0,0,0,428,372,113,11,800,552
2015,14,ERIE,3,PROPRIETARY,1,PRIVATE,1,4-Year/Grad,503000,800000052562,BRYANT & STRATTON COLLEGE - BUFFALO,290,290,0,310,207,103,0,0,0,0,290,310,65,8,600,393.33
2016,14,ERIE,3,PROPRIETARY,1,PRIVATE,1,4-Year/Grad,503000,800000052562,BRYANT & STRATTON COLLEGE - BUFFALO,285,285,0,192,176,16,0,0,0,0,285,192,66,4,477,349
2017,14,ERIE,3,PROPRIETARY,1,PRIVATE,1,4-Year/Grad,503000,800000052562,BRYANT & STRATTON COLLEGE - BUFFALO,312,312,0,179,145,34,0,0,0,0,312,179,93,16,491,371.67
2018,14,ERIE,3,PROPRIETARY,1,PRIVATE,1,4-Year/Grad,503000,800000052562,BRYANT & STRATTON COLLEGE - BUFFALO,316,316,0,171,170,1,0,0,0,0,316,171,66,7,487,373
2019,14,ERIE,3,PROPRIETARY,1,PRIVATE,1,4-Year/Grad,503000,800000052562,BRYANT & STRATTON COLLEGE - BUFFALO,371,371,0,114,114,0,0,0,0,0,371,114,79,2,485,409
2010,14,ERIE,3,PROPRIETARY,1,PRIVATE,1,4-Year/Grad,503010,800000053019,BRYANT & STRATTON COLLEGE- AMHERST,322,322,0,245,189,56,0,0,0,0,322,245,114,23,567,403.67
2011,14,ERIE,3,PROPRIETARY,1,PRIVATE,1,4-Year/Grad,503010,800000053019,BRYANT & STRATTON COLLEGE- AMHERST,309,309,0,224,198,26,0,0,0,0,309,224,78,17,533,383.67
2012,14,ERIE,3,PROPRIETARY,1,PRIVATE,1,4-Year/Grad,503010,800000053019,BRYANT & STRATTON COLLEGE- AMHERST,258,258,0,169,157,12,0,0,0,0,258,169,42,2,427,314.33
2013,14,ERIE,3,PROPRIETARY,1,PRIVATE,1,4-Year/Grad,503010,800000053019,BRYANT & STRATTON COLLEGE- AMHERST,246,246,0,167,154,13,0,0,0,0,246,167,44,4,413,301.67
2014,14,ERIE,3,PROPRIETARY,1,PRIVATE,1,4-Year/Grad,503010,800000053019,BRYANT & STRATTON COLLEGE- AMHERST,215,215,0,141,125,16,0,0,0,0,215,141,15,6,356,262
2015,14,ERIE,3,PROPRIETARY,1,PRIVATE,1,4-Year/Grad,503010,800000053019,BRYANT & STRATTON COLLEGE- AMHERST,187,187,0,131,119,12,0,0,0,0,187,131,20,7,318,230.67
2016,14,ERIE,3,PROPRIETARY,1,PRIVATE,1,4-Year/Grad,503010,800000053019,BRYANT & STRATTON COLLEGE- AMHERST,180,180,0,127,113,14,0,0,0,0,180,127,19,3,307,222.33
2017,14,ERIE,3,PROPRIETARY,1,PRIVATE,1,4-Year/Grad,503010,800000053019,BRYANT & STRATTON COLLEGE- AMHERST,170,170,0,112,88,24,0,0,0,0,170,112,34,3,282,207.33
2018,14,ERIE,3,PROPRIETARY,1,PRIVATE,1,4-Year/Grad,503010,800000053019,BRYANT & STRATTON COLLEGE- AMHERST,160,160,0,106,90,16,0,0,0,0,160,106,16,4,266,195.33
2019,14,ERIE,3,PROPRIETARY,1,PRIVATE,1,4-Year/Grad,503010,800000053019,BRYANT & STRATTON COLLEGE- AMHERST,132,132,0,120,95,25,0,0,0,0,132,120,22,2,252,172
2010,14,ERIE,3,PROPRIETARY,1,PRIVATE,1,4-Year/Grad,503020,800000052103,BRYANT & STRATTON COLLEGE - SOUTHTOWNS CAMPUS,1406,1406,0,866,831,35,0,0,0,0,1406,866,478,145,2272,1694.67
2011,14,ERIE,3,PROPRIETARY,1,PRIVATE,1,4-Year/Grad,503020,800000052103,BRYANT & STRATTON COLLEGE - SOUTHTOWNS CAMPUS,1502,1501,1,1094,1094,0,0,0,0,0,1502,1094,516,140,2596,1866.67
2012,14,ERIE,3,PROPRIETARY,1,PRIVATE,1,4-Year/Grad,503020,800000052103,BRYANT & STRATTON COLLEGE - SOUTHTOWNS CAMPUS,1455,1455,0,1102,1049,53,0,0,0,0,1455,1102,167,54,2557,1822.33
2013,14,ERIE,3,PROPRIETARY,1,PRIVATE,1,4-Year/Grad,503020,800000052103,BRYANT & STRATTON COLLEGE - SOUTHTOWNS CAMPUS,1568,1567,1,1141,1064,77,0,0,0,0,1568,1141,198,41,2709,1948.33
2014,14,ERIE,3,PROPRIETARY,1,PRIVATE,1,4-Year/Grad,503020,800000052103,BRYANT & STRATTON COLLEGE - SOUTHTOWNS CAMPUS,1937,1937,0,1208,1154,54,0,0,0,0,1937,1208,244,51,3145,2339.67
2015,14,ERIE,3,PROPRIETARY,1,PRIVATE,1,4-Year/Grad,503020,800000052103,BRYANT & STRATTON COLLEGE - SOUTHTOWNS CAMPUS,1855,1855,0,1606,1251,355,0,0,0,0,1855,1606,267,48,3461,2390.33
2016,14,ERIE,3,PROPRIETARY,1,PRIVATE,1,4-Year/Grad,503020,800000052103,BRYANT & STRATTON COLLEGE - SOUTHTOWNS CAMPUS,2374,2374,0,1496,1454,42,0,0,0,0,2374,1496,392,89,3870,2872.67
2017,14,ERIE,3,PROPRIETARY,1,PRIVATE,1,4-Year/Grad,503020,800000052103,BRYANT & STRATTON COLLEGE - SOUTHTOWNS CAMPUS,2760,2760,0,1676,1641,35,0,0,0,0,2760,1676,697,141,4436,3318.67
2018,14,ERIE,3,PROPRIETARY,1,PRIVATE,1,4-Year/Grad,503020,800000052103,BRYANT & STRATTON COLLEGE - SOUTHTOWNS CAMPUS,3131,3131,0,1641,1635,6,0,0,0,0,3131,1641,324,71,4772,3678
2019,14,ERIE,3,PROPRIETARY,1,PRIVATE,1,4-Year/Grad,503020,800000052103,BRYANT & STRATTON COLLEGE - SOUTHTOWNS CAMPUS,3556,3556,0,1795,1789,6,0,0,0,0,3556,1795,384,84,5351,4154.33
2010,26,MONROE,3,PROPRIETARY,1,PRIVATE,0,2-Year,503500,800000050289,BRYANT & STRATTON COLLEGE - GREECE,319,319,0,102,102,0,0,0,0,0,319,102,96,17,421,353
2011,26,MONROE,3,PROPRIETARY,1,PRIVATE,0,2-Year,503500,800000050289,BRYANT & STRATTON COLLEGE - GREECE,320,320,0,115,115,0,0,0,0,0,320,115,81,6,435,358.33
2012,26,MONROE,3,PROPRIETARY,1,PRIVATE,0,2-Year,503500,800000050289,BRYANT & STRATTON COLLEGE - GREECE,278,278,0,137,102,35,0,0,0,0,278,137,58,8,415,323.67
2013,26,MONROE,3,PROPRIETARY,1,PRIVATE,0,2-Year,503500,800000050289,BRYANT & STRATTON COLLEGE - GREECE,268,268,0,121,113,8,0,0,0,0,268,121,47,5,389,308.33
2014,26,MONROE,3,PROPRIETARY,1,PRIVATE,0,2-Year,503500,800000050289,BRYANT & STRATTON COLLEGE - GREECE,289,289,0,132,112,20,0,0,0,0,289,132,45,3,421,333
2015,26,MONROE,3,PROPRIETARY,1,PRIVATE,0,2-Year,503500,800000050289,BRYANT & STRATTON COLLEGE - GREECE,253,253,0,124,101,23,0,0,0,0,253,124,32,0,377,294.33
2016,26,MONROE,3,PROPRIETARY,1,PRIVATE,0,2-Year,503500,800000050289,BRYANT & STRATTON COLLEGE - GREECE,202,202,0,87,87,0,0,0,0,0,202,87,11,1,289,231
2017,26,MONROE,3,PROPRIETARY,1,PRIVATE,0,2-Year,503500,800000050289,BRYANT & STRATTON COLLEGE - GREECE,198,198,0,76,76,0,0,0,0,0,198,76,13,1,274,223.33
2018,26,MONROE,3,PROPRIETARY,1,PRIVATE,0,2-Year,503500,800000050289,BRYANT & STRATTON COLLEGE - GREECE,155,155,0,60,58,2,0,0,0,0,155,60,25,2,215,175
2019,26,MONROE,3,PROPRIETARY,1,PRIVATE,0,2-Year,503500,800000050289,BRYANT & STRATTON COLLEGE - GREECE,181,181,0,65,64,1,0,0,0,0,181,65,27,1,246,202.67
2010,26,MONROE,3,PROPRIETARY,1,PRIVATE,0,2-Year,503510,800000050091,BRYANT & STRATTON COLLEGE - HENRIETTA,390,390,0,116,112,4,0,0,0,0,390,116,118,16,506,428.67
2011,26,MONROE,3,PROPRIETARY,1,PRIVATE,0,2-Year,503510,800000050091,BRYANT & STRATTON COLLEGE - HENRIETTA,334,334,0,129,97,32,0,0,0,0,334,129,55,5,463,377
2012,26,MONROE,3,PROPRIETARY,1,PRIVATE,0,2-Year,503510,800000050091,BRYANT & STRATTON COLLEGE - HENRIETTA,355,355,0,143,86,57,0,0,0,0,355,143,72,2,498,402.67
2013,26,MONROE,3,PROPRIETARY,1,PRIVATE,0,2-Year,503510,800000050091,BRYANT & STRATTON COLLEGE - HENRIETTA,293,293,0,119,75,44,0,0,0,0,293,119,38,2,412,332.67
2014,26,MONROE,3,PROPRIETARY,1,PRIVATE,0,2-Year,503510,800000050091,BRYANT & STRATTON COLLEGE - HENRIETTA,288,288,0,143,105,38,0,0,0,0,288,143,53,3,431,335.67
2015,26,MONROE,3,PROPRIETARY,1,PRIVATE,0,2-Year,503510,800000050091,BRYANT & STRATTON COLLEGE - HENRIETTA,227,227,0,130,130,0,0,0,0,0,227,130,34,3,357,270.33
2016,26,MONROE,3,PROPRIETARY,1,PRIVATE,0,2-Year,503510,800000050091,BRYANT & STRATTON COLLEGE - HENRIETTA,201,201,0,98,98,0,0,0,0,0,201,98,32,4,299,233.67
2017,26,MONROE,3,PROPRIETARY,1,PRIVATE,0,2-Year,503510,800000050091,BRYANT & STRATTON COLLEGE - HENRIETTA,198,198,0,85,85,0,0,0,0,0,198,85,15,4,283,226.33
2018,26,MONROE,3,PROPRIETARY,1,PRIVATE,0,2-Year,503510,800000050091,BRYANT & STRATTON COLLEGE - HENRIETTA,121,121,0,63,62,1,0,0,0,0,121,63,22,2,184,142
2019,26,MONROE,3,PROPRIETARY,1,PRIVATE,0,2-Year,503510,800000050091,BRYANT & STRATTON COLLEGE - HENRIETTA,89,89,0,61,60,1,0,0,0,0,89,61,15,0,150,109.33
2010,28,NASSAU,3,PROPRIETARY,1,PRIVATE,0,2-Year,503800,800000065216,BUSINESS INFORMATICS CENTER,59,59,0,67,67,0,0,0,0,0,59,67,7,0,126,81.33
2011,28,NASSAU,3,PROPRIETARY,1,PRIVATE,0,2-Year,503800,800000065216,BUSINESS INFORMATICS CENTER,42,42,0,72,72,0,0,0,0,0,42,72,4,0,114,66
2012,28,NASSAU,3,PROPRIETARY,1,PRIVATE,0,2-Year,503800,800000065216,BUSINESS INFORMATICS CENTER,33,33,0,43,43,0,0,0,0,0,33,43,3,0,76,47.33
2013,28,NASSAU,3,PROPRIETARY,1,PRIVATE,0,2-Year,503800,800000065216,BUSINESS INFORMATICS CENTER,30,30,0,29,29,0,0,0,0,0,30,29,4,0,59,39.67
2014,28,NASSAU,3,PROPRIETARY,1,PRIVATE,0,2-Year,503800,800000065216,BUSINESS INFORMATICS CENTER,11,11,0,15,15,0,0,0,0,0,11,15,0,0,26,16
2010,31,NEW YORK,3,PROPRIETARY,1,PRIVATE,1,4-Year/Grad,504300,800000065214,"CHRISTIE'S EDUCATION, INC",0,0,0,0,0,0,0,0,84,0,84,0,0,0,84,84
2011,31,NEW YORK,3,PROPRIETARY,1,PRIVATE,1,4-Year/Grad,504300,800000065214,"CHRISTIE'S EDUCATION, INC",0,0,0,0,0,0,0,0,81,0,81,0,0,0,81,81
2012,31,NEW YORK,3,PROPRIETARY,1,PRIVATE,1,4-Year/Grad,504300,800000065214,"CHRISTIE'S EDUCATION, INC",0,0,0,0,0,0,0,0,44,36,44,36,0,0,80,58.4
2013,31,NEW YORK,3,PROPRIETARY,1,PRIVATE,1,4-Year/Grad,504300,800000065214,"CHRISTIE'S EDUCATION, INC",0,0,0,0,0,0,0,0,28,47,28,47,0,0,75,46.8
2014,31,NEW YORK,3,PROPRIETARY,1,PRIVATE,1,4-Year/Grad,504300,800000065214,"CHRISTIE'S EDUCATION, INC",0,0,0,0,0,0,0,0,36,30,36,30,0,0,66,48
2015,31,NEW YORK,3,PROPRIETARY,1,PRIVATE,1,4-Year/Grad,504300,800000065214,"CHRISTIE'S EDUCATION, INC",0,0,0,0,0,0,0,0,23,36,23,36,0,0,59,37.4
2016,31,NEW YORK,3,PROPRIETARY,1,PRIVATE,1,4-Year/Grad,504300,800000065214,"CHRISTIE'S EDUCATION, INC",0,0,0,0,0,0,0,0,25,28,25,28,0,0,53,36.2
2017,31,NEW YORK,3,PROPRIETARY,1,PRIVATE,1,4-Year/Grad,504300,800000065214,"CHRISTIE'S EDUCATION, INC",0,0,0,0,0,0,0,0,41,41,41,41,0,0,82,57.4
2010,07,CHEMUNG,3,PROPRIETARY,1,PRIVATE,0,2-Year,504400,800000054090,ELMIRA BUSINESS INST,205,205,0,78,78,0,0,0,0,0,205,78,86,13,283,231
2011,07,CHEMUNG,3,PROPRIETARY,1,PRIVATE,0,2-Year,504400,800000054090,ELMIRA BUSINESS INST,192,192,0,43,43,0,0,0,0,0,192,43,85,11,235,206.33
2012,07,CHEMUNG,3,PROPRIETARY,1,PRIVATE,0,2-Year,504400,800000054090,ELMIRA BUSINESS INST,136,136,0,40,40,0,0,0,0,0,136,40,38,5,176,149.33
2013,07,CHEMUNG,3,PROPRIETARY,1,PRIVATE,0,2-Year,504400,800000054090,ELMIRA BUSINESS INST,157,157,0,30,30,0,0,0,0,0,157,30,23,1,187,167
2014,07,CHEMUNG,3,PROPRIETARY,1,PRIVATE,0,2-Year,504400,800000054090,ELMIRA BUSINESS INST,158,158,0,38,38,0,0,0,0,0,158,38,7,1,196,170.67
2015,07,CHEMUNG,3,PROPRIETARY,1,PRIVATE,0,2-Year,504400,800000054090,ELMIRA BUSINESS INST,104,104,0,55,53,2,0,0,0,0,104,55,15,0,159,122.33
2016,07,CHEMUNG,3,PROPRIETARY,1,PRIVATE,0,2-Year,504400,800000054090,ELMIRA BUSINESS INST,90,90,0,42,41,1,0,0,0,0,90,42,6,1,132,104
2017,07,CHEMUNG,3,PROPRIETARY,1,PRIVATE,0,2-Year,504400,800000054090,ELMIRA BUSINESS INST,67,67,0,25,25,0,0,0,0,0,67,25,3,1,92,75.33
2018,07,CHEMUNG,3,PROPRIETARY,1,PRIVATE,0,2-Year,504400,800000054090,ELMIRA BUSINESS INST,4,4,0,2,2,0,0,0,0,0,4,2,0,0,6,4.67
2010,03,BROOME,3,PROPRIETARY,1,PRIVATE,0,2-Year,504410,800000065215,ELMIRA BUSINESS INSTITUTE - VESTAL EXECUTIVE PARK,224,224,0,45,45,0,0,0,0,0,224,45,74,7,269,239
2011,03,BROOME,3,PROPRIETARY,1,PRIVATE,0,2-Year,504410,800000065215,ELMIRA BUSINESS INSTITUTE - VESTAL EXECUTIVE PARK,186,186,0,39,38,1,0,0,0,0,186,39,71,5,225,199
2012,03,BROOME,3,PROPRIETARY,1,PRIVATE,0,2-Year,504410,800000065215,ELMIRA BUSINESS INSTITUTE - VESTAL EXECUTIVE PARK,168,168,0,46,46,0,0,0,0,0,168,46,61,8,214,183.33
2013,03,BROOME,3,PROPRIETARY,1,PRIVATE,0,2-Year,504410,800000065215,ELMIRA BUSINESS INSTITUTE - VESTAL EXECUTIVE PARK,164,164,0,86,86,0,0,0,0,0,164,86,34,6,250,192.67
2014,03,BROOME,3,PROPRIETARY,1,PRIVATE,0,2-Year,504410,800000065215,ELMIRA BUSINESS INSTITUTE - VESTAL EXECUTIVE PARK,151,151,0,54,54,0,0,0,0,0,151,54,14,1,205,169
2015,03,BROOME,3,PROPRIETARY,1,PRIVATE,0,2-Year,504410,800000065215,ELMIRA BUSINESS INSTITUTE - VESTAL EXECUTIVE PARK,123,123,0,45,43,2,0,0,0,0,123,45,25,3,168,138
2016,03,BROOME,3,PROPRIETARY,1,PRIVATE,0,2-Year,504410,800000065215,ELMIRA BUSINESS INSTITUTE - VESTAL EXECUTIVE PARK,103,103,0,43,43,0,0,0,0,0,103,43,2,5,146,117.33
2017,03,BROOME,3,PROPRIETARY,1,PRIVATE,0,2-Year,504410,800000065215,ELMIRA BUSINESS INSTITUTE - VESTAL EXECUTIVE PARK,77,77,0,36,36,0,0,0,0,0,77,36,5,4,113,89
2018,03,BROOME,3,PROPRIETARY,1,PRIVATE,0,2-Year,504410,800000065215,ELMIRA BUSINESS INSTITUTE - VESTAL EXECUTIVE PARK,101,101,0,39,39,0,0,0,0,0,101,39,4,1,140,114
2019,03,BROOME,3,PROPRIETARY,1,PRIVATE,0,2-Year,504410,800000065215,ELMIRA BUSINESS INSTITUTE - VESTAL EXECUTIVE PARK,75,75,0,25,25,0,0,0,0,0,75,25,4,3,100,83.33
2010,31,NEW YORK,3,PROPRIETARY,1,PRIVATE,1,4-Year/Grad,504520,800000065224,DEVRY COLLEGE OF NEW YORK,1184,1184,0,657,629,28,0,0,255,702,1439,1359,313,195,2798,1938.8
2011,31,NEW YORK,3,PROPRIETARY,1,PRIVATE,1,4-Year/Grad,504520,800000065224,DEVRY COLLEGE OF NEW YORK,916,916,0,715,713,2,0,0,221,683,1137,1398,162,159,2535,1648.53
2012,31,NEW YORK,3,PROPRIETARY,1,PRIVATE,1,4-Year/Grad,504520,800000065224,DEVRY COLLEGE OF NEW YORK,882,881,1,680,679,1,0,0,225,621,1107,1301,88,87,2408,1582.07
2013,31,NEW YORK,3,PROPRIETARY,1,PRIVATE,1,4-Year/Grad,504520,800000065224,DEVRY COLLEGE OF NEW YORK,931,931,0,471,467,4,0,0,231,494,1162,965,88,26,2127,1516.6
2014,31,NEW YORK,3,PROPRIETARY,1,PRIVATE,1,4-Year/Grad,504520,800000065224,DEVRY COLLEGE OF NEW YORK,893,893,0,409,408,1,0,0,236,488,1129,897,43,23,2026,1460.53
2015,31,NEW YORK,3,PROPRIETARY,1,PRIVATE,1,4-Year/Grad,504520,800000065224,DEVRY COLLEGE OF NEW YORK,791,791,0,377,375,2,0,0,212,495,1003,872,36,20,1875,1326.67
2016,31,NEW YORK,3,PROPRIETARY,1,PRIVATE,1,4-Year/Grad,504520,800000065224,DEVRY COLLEGE OF NEW YORK,682,682,0,433,431,2,0,0,162,457,844,890,27,16,1734,1171.13
2017,31,NEW YORK,3,PROPRIETARY,1,PRIVATE,1,4-Year/Grad,504520,800000065224,DEVRY COLLEGE OF NEW YORK,593,593,0,352,347,5,0,0,180,403,773,755,27,12,1528,1051.53
2018,31,NEW YORK,3,PROPRIETARY,1,PRIVATE,1,4-Year/Grad,504520,800000065224,DEVRY COLLEGE OF NEW YORK,613,613,0,359,350,9,0,0,110,389,723,748,39,21,1471,998.27
2019,31,NEW YORK,3,PROPRIETARY,1,PRIVATE,1,4-Year/Grad,504520,800000065224,DEVRY COLLEGE OF NEW YORK,545,545,0,291,287,4,0,0,115,312,660,603,34,10,1263,881.8
2010,58,SUFFOLK,3,PROPRIETARY,1,PRIVATE,0,2-Year,505000,800000037324,FIVE TOWNS COLLEGE,1013,1013,0,32,29,3,0,0,28,64,1041,96,234,0,1137,1077.27
2011,58,SUFFOLK,3,PROPRIETARY,1,PRIVATE,0,2-Year,505000,800000037324,FIVE TOWNS COLLEGE,937,937,0,39,36,3,0,0,24,21,961,60,222,1,1021,982.4
2012,58,SUFFOLK,3,PROPRIETARY,1,PRIVATE,0,2-Year,505000,800000037324,FIVE TOWNS COLLEGE,824,824,0,34,27,7,0,0,18,26,842,60,177,2,902,863.73
2013,58,SUFFOLK,3,PROPRIETARY,1,PRIVATE,0,2-Year,505000,800000037324,FIVE TOWNS COLLEGE,724,724,0,23,18,5,0,0,16,25,740,48,148,2,788,757.67
2014,58,SUFFOLK,3,PROPRIETARY,1,PRIVATE,0,2-Year,505000,800000037324,FIVE TOWNS COLLEGE,604,604,0,34,24,10,0,0,17,20,621,54,116,2,675,640.33
2015,58,SUFFOLK,3,PROPRIETARY,1,PRIVATE,0,2-Year,505000,800000037324,FIVE TOWNS COLLEGE,611,611,0,45,19,26,0,0,19,8,630,53,115,5,683,648.2
2016,58,SUFFOLK,3,PROPRIETARY,1,PRIVATE,0,2-Year,505000,800000037324,FIVE TOWNS COLLEGE,605,605,0,65,27,38,0,0,12,23,617,88,147,8,705,647.87
2017,58,SUFFOLK,3,PROPRIETARY,1,PRIVATE,0,2-Year,505000,800000037324,FIVE TOWNS COLLEGE,591,591,0,86,24,62,0,0,25,16,616,102,147,6,718,651.07
2018,58,SUFFOLK,3,PROPRIETARY,1,PRIVATE,0,2-Year,505000,800000037324,FIVE TOWNS COLLEGE,557,557,0,45,33,12,0,0,18,28,575,73,136,7,648,601.2
2019,58,SUFFOLK,3,PROPRIETARY,1,PRIVATE,0,2-Year,505000,800000037324,FIVE TOWNS COLLEGE,590,590,0,30,27,3,0,0,12,24,602,54,135,2,656,621.6
2010,31,NEW YORK,3,PROPRIETARY,1,PRIVATE,1,4-Year/Grad,505100,800000048189,GLOBE INST OF TECH INC,565,565,0,16,9,7,0,0,0,0,565,16,214,2,581,570.33
2011,31,NEW YORK,3,PROPRIETARY,1,PRIVATE,1,4-Year/Grad,505100,800000048189,GLOBE INST OF TECH INC,657,656,1,8,6,2,0,0,0,0,657,8,257,0,665,659.67
2012,31,NEW YORK,3,PROPRIETARY,1,PRIVATE,1,4-Year/Grad,505100,800000048189,GLOBE INST OF TECH INC,726,725,1,26,14,12,0,0,0,0,726,26,290,0,752,734.67
2013,31,NEW YORK,3,PROPRIETARY,1,PRIVATE,1,4-Year/Grad,505100,800000048189,GLOBE INST OF TECH INC,528,524,4,25,23,2,0,0,0,0,528,25,226,3,553,536.33
2014,31,NEW YORK,3,PROPRIETARY,1,PRIVATE,1,4-Year/Grad,505100,800000048189,GLOBE INST OF TECH INC,469,469,0,21,18,3,0,0,0,0,469,21,159,0,490,476
2015,31,NEW YORK,3,PROPRIETARY,1,PRIVATE,1,4-Year/Grad,505100,800000048189,GLOBE INST OF TECH INC,437,436,1,10,8,2,0,0,0,0,437,10,149,0,447,440.33
2010,58,SUFFOLK,3,PROPRIETARY,1,PRIVATE,0,2-Year,505600,800000037775,ISLAND DRAFTING & TECH INST,133,133,0,0,0,0,0,0,0,0,133,0,41,0,133,133
2011,58,SUFFOLK,3,PROPRIETARY,1,PRIVATE,0,2-Year,505600,800000037775,ISLAND DRAFTING & TECH INST,116,116,0,0,0,0,0,0,0,0,116,0,53,0,116,116
2012,58,SUFFOLK,3,PROPRIETARY,1,PRIVATE,0,2-Year,505600,800000037775,ISLAND DRAFTING & TECH INST,118,118,0,0,0,0,0,0,0,0,118,0,50,0,118,118
2013,58,SUFFOLK,3,PROPRIETARY,1,PRIVATE,0,2-Year,505600,800000037775,ISLAND DRAFTING & TECH INST,103,103,0,0,0,0,0,0,0,0,103,0,38,0,103,103
2014,58,SUFFOLK,3,PROPRIETARY,1,PRIVATE,0,2-Year,505600,800000037775,ISLAND DRAFTING & TECH INST,112,112,0,0,0,0,0,0,0,0,112,0,57,0,112,112
2015,58,SUFFOLK,3,PROPRIETARY,1,PRIVATE,0,2-Year,505600,800000037775,ISLAND DRAFTING & TECH INST,118,118,0,0,0,0,0,0,0,0,118,0,51,0,118,118
2016,58,SUFFOLK,3,PROPRIETARY,1,PRIVATE,0,2-Year,505600,800000037775,ISLAND DRAFTING & TECH INST,108,108,0,0,0,0,0,0,0,0,108,0,48,0,108,108
2017,58,SUFFOLK,3,PROPRIETARY,1,PRIVATE,0,2-Year,505600,800000037775,ISLAND DRAFTING & TECH INST,91,91,0,0,0,0,0,0,0,0,91,0,39,0,91,91
2018,58,SUFFOLK,3,PROPRIETARY,1,PRIVATE,0,2-Year,505600,800000037775,ISLAND DRAFTING & TECH INST,82,82,0,0,0,0,0,0,0,0,82,0,41,0,82,82
2019,58,SUFFOLK,3,PROPRIETARY,1,PRIVATE,0,2-Year,505600,800000037775,ISLAND DRAFTING & TECH INST,91,91,0,0,0,0,0,0,0,0,91,0,43,0,91,91
2010,01,ALBANY,3,PROPRIETARY,1,PRIVATE,0,2-Year,505700,800000066231,ITT TECHNICAL INSTITUTE - ALBANY,454,454,0,73,73,0,0,0,0,0,454,73,93,2,527,478.33
2011,01,ALBANY,3,PROPRIETARY,1,PRIVATE,0,2-Year,505700,800000066231,ITT TECHNICAL INSTITUTE - ALBANY,298,298,0,81,81,0,0,0,0,0,298,81,46,0,379,325
2012,01,ALBANY,3,PROPRIETARY,1,PRIVATE,0,2-Year,505700,800000066231,ITT TECHNICAL INSTITUTE - ALBANY,293,293,0,106,106,0,0,0,0,0,293,106,42,0,399,328.33
2013,01,ALBANY,3,PROPRIETARY,1,PRIVATE,0,2-Year,505700,800000066231,ITT TECHNICAL INSTITUTE - ALBANY,264,264,0,27,27,0,0,0,0,0,264,27,77,0,291,273
2014,01,ALBANY,3,PROPRIETARY,1,PRIVATE,0,2-Year,505700,800000066231,ITT TECHNICAL INSTITUTE - ALBANY,206,206,0,35,35,0,0,0,0,0,206,35,57,0,241,217.67
2015,01,ALBANY,3,PROPRIETARY,1,PRIVATE,0,2-Year,505700,800000066231,ITT TECHNICAL INSTITUTE - ALBANY,173,173,0,25,25,0,0,0,0,0,173,25,69,2,198,181.33
2010,14,ERIE,3,PROPRIETARY,1,PRIVATE,0,2-Year,505800,800000066233,ITT TECHNICAL INSTITUTE - GETZVILLE,566,566,0,93,93,0,0,0,0,0,566,93,260,15,659,597
2011,14,ERIE,3,PROPRIETARY,1,PRIVATE,0,2-Year,505800,800000066233,ITT TECHNICAL INSTITUTE - GETZVILLE,511,511,0,80,80,0,0,0,0,0,511,80,196,5,591,537.67
2012,14,ERIE,3,PROPRIETARY,1,PRIVATE,0,2-Year,505800,800000066233,ITT TECHNICAL INSTITUTE - GETZVILLE,362,362,0,82,82,0,0,0,0,0,362,82,127,6,444,389.33
2013,14,ERIE,3,PROPRIETARY,1,PRIVATE,0,2-Year,505800,800000066233,ITT TECHNICAL INSTITUTE - GETZVILLE,319,319,0,45,45,0,0,0,0,0,319,45,153,2,364,334
2010,42,ONONDAGA,3,PROPRIETARY,1,PRIVATE,0,2-Year,505900,800000066232,ITT TECHNICAL INSTITUTE - LIVERPOOL,347,347,0,49,49,0,0,0,0,0,347,49,68,2,396,363.33
2011,42,ONONDAGA,3,PROPRIETARY,1,PRIVATE,0,2-Year,505900,800000066232,ITT TECHNICAL INSTITUTE - LIVERPOOL,252,252,0,72,72,0,0,0,0,0,252,72,79,3,324,276
2012,42,ONONDAGA,3,PROPRIETARY,1,PRIVATE,0,2-Year,505900,800000066232,ITT TECHNICAL INSTITUTE - LIVERPOOL,229,229,0,69,69,0,0,0,0,0,229,69,81,4,298,252
2013,42,ONONDAGA,3,PROPRIETARY,1,PRIVATE,0,2-Year,505900,800000066232,ITT TECHNICAL INSTITUTE - LIVERPOOL,219,219,0,53,53,0,0,0,0,0,219,53,97,17,272,236.67
2014,42,ONONDAGA,3,PROPRIETARY,1,PRIVATE,0,2-Year,505900,800000066232,ITT TECHNICAL INSTITUTE - LIVERPOOL,173,173,0,29,29,0,0,0,0,0,173,29,74,10,202,182.67
2010,06,CHAUTAUQUA,3,PROPRIETARY,1,PRIVATE,0,2-Year,506000,800000054238,JAMESTOWN BUSINESS COLLEGE,375,375,0,11,11,0,0,0,0,0,375,11,77,0,386,378.67
2011,06,CHAUTAUQUA,3,PROPRIETARY,1,PRIVATE,0,2-Year,506000,800000054238,JAMESTOWN BUSINESS COLLEGE,304,304,0,13,13,0,0,0,0,0,304,13,69,0,317,308.33
2012,06,CHAUTAUQUA,3,PROPRIETARY,1,PRIVATE,0,2-Year,506000,800000054238,JAMESTOWN BUSINESS COLLEGE,288,288,0,6,6,0,0,0,0,0,288,6,70,0,294,290
2013,06,CHAUTAUQUA,3,PROPRIETARY,1,PRIVATE,0,2-Year,506000,800000054238,JAMESTOWN BUSINESS COLLEGE,269,269,0,6,6,0,0,0,0,0,269,6,68,0,275,271
2014,06,CHAUTAUQUA,3,PROPRIETARY,1,PRIVATE,0,2-Year,506000,800000054238,JAMESTOWN BUSINESS COLLEGE,314,314,0,4,4,0,0,0,0,0,314,4,114,0,318,315.33
2015,06,CHAUTAUQUA,3,PROPRIETARY,1,PRIVATE,0,2-Year,506000,800000054238,JAMESTOWN BUSINESS COLLEGE,286,286,0,10,10,0,0,0,0,0,286,10,92,0,296,289.33
2016,06,CHAUTAUQUA,3,PROPRIETARY,1,PRIVATE,0,2-Year,506000,800000054238,JAMESTOWN BUSINESS COLLEGE,305,305,0,6,6,0,0,0,0,0,305,6,99,0,311,307
2017,06,CHAUTAUQUA,3,PROPRIETARY,1,PRIVATE,0,2-Year,506000,800000054238,JAMESTOWN BUSINESS COLLEGE,312,312,0,11,11,0,0,0,0,0,312,11,115,0,323,315.67
2018,06,CHAUTAUQUA,3,PROPRIETARY,1,PRIVATE,0,2-Year,506000,800000054238,JAMESTOWN BUSINESS COLLEGE,291,291,0,7,7,0,0,0,0,0,291,7,111,0,298,293.33
2019,06,CHAUTAUQUA,3,PROPRIETARY,1,PRIVATE,0,2-Year,506000,800000054238,JAMESTOWN BUSINESS COLLEGE,295,295,0,10,10,0,0,0,0,0,295,10,113,0,305,298.33
2010,58,SUFFOLK,3,PROPRIETARY,1,PRIVATE,0,2-Year,506500,800000037325,SBI CAMPUS - AN AFFILIATE OF SANFORD-BROWN,433,433,0,156,156,0,0,0,0,0,433,156,47,2,589,485
2011,58,SUFFOLK,3,PROPRIETARY,1,PRIVATE,0,2-Year,506500,800000037325,SBI CAMPUS - AN AFFILIATE OF SANFORD-BROWN,327,327,0,254,254,0,0,0,0,0,327,254,55,6,581,411.67
2012,58,SUFFOLK,3,PROPRIETARY,1,PRIVATE,0,2-Year,506500,800000037325,SBI CAMPUS - AN AFFILIATE OF SANFORD-BROWN,205,205,0,154,154,0,0,0,0,0,205,154,78,9,359,256.33
2013,58,SUFFOLK,3,PROPRIETARY,1,PRIVATE,0,2-Year,506500,800000037325,SBI CAMPUS - AN AFFILIATE OF SANFORD-BROWN,243,243,0,31,31,0,0,0,0,0,243,31,66,1,274,253.33
2014,58,SUFFOLK,3,PROPRIETARY,1,PRIVATE,0,2-Year,506500,800000037325,SBI CAMPUS - AN AFFILIATE OF SANFORD-BROWN,210,210,0,30,30,0,0,0,0,0,210,30,30,3,240,220
2015,58,SUFFOLK,3,PROPRIETARY,1,PRIVATE,0,2-Year,506500,800000037325,SBI CAMPUS - AN AFFILIATE OF SANFORD-BROWN,90,90,0,38,38,0,0,0,0,0,90,38,90,38,128,102.67
2010,31,NEW YORK,3,PROPRIETARY,1,PRIVATE,1,4-Year/Grad,507500,800000047663,LABORATORY INST OF MERCHANDISING,1452,1452,0,44,41,3,0,0,47,24,1499,68,338,0,1567,1523.27
2011,31,NEW YORK,3,PROPRIETARY,1,PRIVATE,1,4-Year/Grad,507500,800000047663,LABORATORY INST OF MERCHANDISING,1461,1461,0,64,64,0,0,0,39,28,1500,92,324,2,1592,1532.53
2012,31,NEW YORK,3,PROPRIETARY,1,PRIVATE,1,4-Year/Grad,507500,800000047663,LABORATORY INST OF MERCHANDISING,1391,1387,4,86,80,6,0,0,43,35,1434,121,257,2,1555,1476.67
2013,31,NEW YORK,3,PROPRIETARY,1,PRIVATE,1,4-Year/Grad,507500,800000047663,LABORATORY INST OF MERCHANDISING,1422,1418,4,138,90,48,0,0,102,32,1524,170,299,2,1694,1582.8
2014,31,NEW YORK,3,PROPRIETARY,1,PRIVATE,1,4-Year/Grad,507500,800000047663,LABORATORY INST OF MERCHANDISING,1424,1421,3,128,127,1,0,0,120,65,1544,193,280,5,1737,1612.67
2015,31,NEW YORK,3,PROPRIETARY,1,PRIVATE,1,4-Year/Grad,507500,800000047663,LABORATORY INST OF MERCHANDISING,1428,1428,0,87,87,0,0,0,113,72,1541,159,267,2,1700,1598.8
2016,31,NEW YORK,3,PROPRIETARY,1,PRIVATE,1,4-Year/Grad,507500,800000047663,LABORATORY INST OF MERCHANDISING,1400,1400,0,99,99,0,0,0,147,74,1547,173,255,5,1720,1609.6
2017,31,NEW YORK,3,PROPRIETARY,1,PRIVATE,1,4-Year/Grad,507500,800000047663,LABORATORY INST OF MERCHANDISING,1306,1306,0,121,121,0,0,0,113,173,1419,294,258,19,1713,1528.53
2018,31,NEW YORK,3,PROPRIETARY,1,PRIVATE,1,4-Year/Grad,507500,800000047663,LABORATORY INST OF MERCHANDISING,1391,1391,0,112,112,0,0,0,153,125,1544,237,289,9,1781,1631.33
2019,31,NEW YORK,3,PROPRIETARY,1,PRIVATE,1,4-Year/Grad,507500,800000047663,LABORATORY INST OF MERCHANDISING,1276,1265,11,185,185,0,0,0,129,160,1405,345,264,4,1750,1530.67
2010,01,ALBANY,3,PROPRIETARY,1,PRIVATE,0,2-Year,507600,800000055382,MILDRED ELLEY SCHOOL,869,869,0,12,10,2,0,0,0,0,869,12,191,2,881,873
2011,01,ALBANY,3,PROPRIETARY,1,PRIVATE,0,2-Year,507600,800000055382,MILDRED ELLEY SCHOOL,795,795,0,45,43,2,0,0,0,0,795,45,161,2,840,810
2012,01,ALBANY,3,PROPRIETARY,1,PRIVATE,0,2-Year,507600,800000055382,MILDRED ELLEY SCHOOL,740,740,0,90,89,1,0,0,0,0,740,90,122,27,830,770
2013,01,ALBANY,3,PROPRIETARY,1,PRIVATE,0,2-Year,507600,800000055382,MILDRED ELLEY SCHOOL,763,763,0,141,139,2,0,0,0,0,763,141,181,23,904,810
2014,01,ALBANY,3,PROPRIETARY,1,PRIVATE,0,2-Year,507600,800000055382,MILDRED ELLEY SCHOOL,603,603,0,145,145,0,0,0,0,0,603,145,111,20,748,651.33
2015,01,ALBANY,3,PROPRIETARY,1,PRIVATE,0,2-Year,507600,800000055382,MILDRED ELLEY SCHOOL,638,638,0,101,101,0,0,0,0,0,638,101,126,12,739,671.67
2016,01,ALBANY,3,PROPRIETARY,1,PRIVATE,0,2-Year,507600,800000055382,MILDRED ELLEY SCHOOL,597,597,0,86,86,0,0,0,0,0,597,86,99,5,683,625.67
2017,01,ALBANY,3,PROPRIETARY,1,PRIVATE,0,2-Year,507600,800000055382,MILDRED ELLEY SCHOOL,468,468,0,53,53,0,0,0,0,0,468,53,88,14,521,485.67
2018,01,ALBANY,3,PROPRIETARY,1,PRIVATE,0,2-Year,507600,800000055382,MILDRED ELLEY SCHOOL,393,393,0,29,29,0,0,0,0,0,393,29,99,8,422,402.67
2019,01,ALBANY,3,PROPRIETARY,1,PRIVATE,0,2-Year,507600,800000055382,MILDRED ELLEY SCHOOL,355,355,0,5,5,0,0,0,0,0,355,5,75,0,360,356.67
2018,31,NEW YORK,3,PROPRIETARY,1,PRIVATE,0,2-Year,507610,800000089794,MILDRED ELLEY-NYC,993,993,0,0,0,0,0,0,0,0,993,0,221,0,993,993
2019,31,NEW YORK,3,PROPRIETARY,1,PRIVATE,0,2-Year,507610,800000089794,MILDRED ELLEY-NYC,1056,1056,0,0,0,0,0,0,0,0,1056,0,191,0,1056,1056
2016,58,SUFFOLK,3,PROPRIETARY,1,PRIVATE,0,2-Year,507800,800000037277,LONG ISLAND BUSINESS INST,1,1,0,95,88,7,0,0,0,0,1,95,1,6,96,32.67
2017,58,SUFFOLK,3,PROPRIETARY,1,PRIVATE,0,2-Year,507800,800000037277,LONG ISLAND BUSINESS INST,0,0,0,88,79,9,0,0,0,0,0,88,0,1,88,29.33
2018,58,SUFFOLK,3,PROPRIETARY,1,PRIVATE,0,2-Year,507800,800000037277,LONG ISLAND BUSINESS INST,1,1,0,82,66,16,0,0,0,0,1,82,0,4,83,28.33
2019,58,SUFFOLK,3,PROPRIETARY,1,PRIVATE,0,2-Year,507800,800000037277,LONG ISLAND BUSINESS INST,3,3,0,80,68,12,0,0,0,0,3,80,0,4,83,29.67
2010,34,QUEENS,3,PROPRIETARY,1,PRIVATE,0,2-Year,507810,800000065120,LONG ISLAND BUSINESS INSTITUTE - FLUSHING,400,399,1,192,174,18,0,0,0,0,400,192,132,11,592,464
2011,34,QUEENS,3,PROPRIETARY,1,PRIVATE,0,2-Year,507810,800000065120,LONG ISLAND BUSINESS INSTITUTE - FLUSHING,373,373,0,186,156,30,0,0,0,0,373,186,143,11,559,435
2012,34,QUEENS,3,PROPRIETARY,1,PRIVATE,0,2-Year,507810,800000065120,LONG ISLAND BUSINESS INSTITUTE - FLUSHING,380,378,2,133,110,23,0,0,0,0,380,133,93,19,513,424.33
2013,34,QUEENS,3,PROPRIETARY,1,PRIVATE,0,2-Year,507810,800000065120,LONG ISLAND BUSINESS INSTITUTE - FLUSHING,312,312,0,135,105,30,0,0,0,0,312,135,82,3,447,357
2014,34,QUEENS,3,PROPRIETARY,1,PRIVATE,0,2-Year,507810,800000065120,LONG ISLAND BUSINESS INSTITUTE - FLUSHING,289,286,3,109,90,19,0,0,0,0,289,109,96,1,398,325.33
2015,34,QUEENS,3,PROPRIETARY,1,PRIVATE,0,2-Year,507810,800000065120,LONG ISLAND BUSINESS INSTITUTE - FLUSHING,458,456,2,126,109,17,0,0,0,0,458,126,110,7,584,500
2016,34,QUEENS,3,PROPRIETARY,1,PRIVATE,0,2-Year,507810,800000065120,LONG ISLAND BUSINESS INSTITUTE - FLUSHING,500,496,4,26,21,5,0,0,0,0,500,26,172,3,526,508.67
2017,34,QUEENS,3,PROPRIETARY,1,PRIVATE,0,2-Year,507810,800000065120,LONG ISLAND BUSINESS INSTITUTE - FLUSHING,600,598,2,32,21,11,0,0,0,0,600,32,248,1,632,610.67
2018,34,QUEENS,3,PROPRIETARY,1,PRIVATE,0,2-Year,507810,800000065120,LONG ISLAND BUSINESS INSTITUTE - FLUSHING,556,551,5,27,22,5,0,0,0,0,556,27,187,1,583,565
2019,34,QUEENS,3,PROPRIETARY,1,PRIVATE,0,2-Year,507810,800000065120,LONG ISLAND BUSINESS INSTITUTE - FLUSHING,887,868,19,41,25,16,0,0,0,0,887,41,340,5,928,900.67
2010,31,NEW YORK,3,PROPRIETARY,1,PRIVATE,0,2-Year,507900,800000048139,MANDL SCHOOL INC,656,656,0,60,60,0,0,0,0,0,656,60,327,0,716,676
2011,31,NEW YORK,3,PROPRIETARY,1,PRIVATE,0,2-Year,507900,800000048139,MANDL SCHOOL INC,813,813,0,69,69,0,0,0,0,0,813,69,300,0,882,836
2012,31,NEW YORK,3,PROPRIETARY,1,PRIVATE,0,2-Year,507900,800000048139,MANDL SCHOOL INC,872,872,0,3,3,0,0,0,0,0,872,3,222,1,875,873
2013,31,NEW YORK,3,PROPRIETARY,1,PRIVATE,0,2-Year,507900,800000048139,MANDL SCHOOL INC,778,778,0,5,5,0,0,0,0,0,778,5,206,2,783,779.67
2014,31,NEW YORK,3,PROPRIETARY,1,PRIVATE,0,2-Year,507900,800000048139,MANDL SCHOOL INC,713,713,0,47,47,0,0,0,0,0,713,47,196,0,760,728.67
2015,31,NEW YORK,3,PROPRIETARY,1,PRIVATE,0,2-Year,507900,800000048139,MANDL SCHOOL INC,674,674,0,47,47,0,0,0,0,0,674,47,91,0,721,689.67
2016,31,NEW YORK,3,PROPRIETARY,1,PRIVATE,0,2-Year,507900,800000048139,MANDL SCHOOL INC,462,462,0,186,186,0,0,0,0,0,462,186,66,6,648,524
2018,31,NEW YORK,3,PROPRIETARY,1,PRIVATE,0,2-Year,507900,800000048139,MANDL SCHOOL INC,509,509,0,71,71,0,0,0,0,0,509,71,216,1,580,532.67
2019,31,NEW YORK,3,PROPRIETARY,1,PRIVATE,0,2-Year,507900,800000048139,MANDL SCHOOL INC,463,463,0,55,55,0,0,0,0,0,463,55,210,5,518,481.33
2010,32,BRONX,3,PROPRIETARY,1,PRIVATE,1,4-Year/Grad,508000,800000046101,MONROE COLLEGE,5000,4994,6,1528,1105,423,0,0,239,205,5239,1733,1117,261,6972,5830.33
2011,32,BRONX,3,PROPRIETARY,1,PRIVATE,1,4-Year/Grad,508000,800000046101,MONROE COLLEGE,5016,5008,8,1747,1062,685,0,0,214,163,5230,1910,1143,34,7140,5877.53
2012,32,BRONX,3,PROPRIETARY,1,PRIVATE,1,4-Year/Grad,508000,800000046101,MONROE COLLEGE,5375,5372,3,1748,1096,652,0,0,172,204,5547,1952,1316,35,7499,6211.27
2013,32,BRONX,3,PROPRIETARY,1,PRIVATE,1,4-Year/Grad,508000,800000046101,MONROE COLLEGE,4890,4887,3,1653,1294,359,0,0,211,197,5101,1850,1151,73,6951,5730.8
2014,32,BRONX,3,PROPRIETARY,1,PRIVATE,1,4-Year/Grad,508000,800000046101,MONROE COLLEGE,4771,4767,4,1723,1400,323,0,0,266,234,5037,1957,993,65,6994,5704.93
2015,32,BRONX,3,PROPRIETARY,1,PRIVATE,1,4-Year/Grad,508000,800000046101,MONROE COLLEGE,4532,4528,4,1914,1486,428,0,0,212,448,4744,2362,1078,107,7106,5561.2
2016,32,BRONX,3,PROPRIETARY,1,PRIVATE,1,4-Year/Grad,508000,800000046101,MONROE COLLEGE,2264,2260,4,1411,1103,308,0,0,139,206,2403,1617,435,58,4020,2955.73
2017,32,BRONX,3,PROPRIETARY,1,PRIVATE,1,4-Year/Grad,508000,800000046101,MONROE COLLEGE,2070,2070,0,1314,1018,296,0,0,99,202,2169,1516,510,70,3685,2687.8
2018,32,BRONX,3,PROPRIETARY,1,PRIVATE,1,4-Year/Grad,508000,800000046101,MONROE COLLEGE,2201,2199,2,1087,1007,80,0,0,114,218,2315,1305,528,88,3620,2764.53
2019,32,BRONX,3,PROPRIETARY,1,PRIVATE,1,4-Year/Grad,508000,800000046101,MONROE COLLEGE,2258,2257,1,1312,1226,86,0,0,108,246,2366,1558,582,186,3924,2901.73
2016,66,WESTCHESTER,3,PROPRIETARY,1,PRIVATE,1,4-Year/Grad,508010,800000035117,MONROE COLLEGE-NEW ROCHELLE BR CAMPS,2084,2084,0,289,218,71,0,0,480,99,2564,388,644,24,2952,2699.93
2017,66,WESTCHESTER,3,PROPRIETARY,1,PRIVATE,1,4-Year/Grad,508010,800000035117,MONROE COLLEGE-NEW ROCHELLE BR CAMPS,2060,2058,2,256,231,25,0,0,335,132,2395,388,688,20,2783,2533.13
2018,66,WESTCHESTER,3,PROPRIETARY,1,PRIVATE,1,4-Year/Grad,508010,800000035117,MONROE COLLEGE-NEW ROCHELLE BR CAMPS,2069,2069,0,222,209,13,0,0,310,139,2379,361,605,22,2740,2508.6
2019,66,WESTCHESTER,3,PROPRIETARY,1,PRIVATE,1,4-Year/Grad,508010,800000035117,MONROE COLLEGE-NEW ROCHELLE BR CAMPS,1890,1889,1,221,204,17,0,0,345,109,2235,330,560,22,2565,2352.27
2018,34,QUEENS,3,PROPRIETARY,1,PRIVATE,0,2-Year,508100,800000090087,NEW YORK AUTOMOTIVE & DIESEL INSTITUTE,300,128,172,115,34,81,0,0,0,0,300,115,104,38,415,338.33
2019,34,QUEENS,3,PROPRIETARY,1,PRIVATE,0,2-Year,508100,800000090087,NEW YORK AUTOMOTIVE & DIESEL INSTITUTE,279,86,193,93,24,69,0,0,0,0,279,93,97,25,372,310
2010,31,NEW YORK,3,PROPRIETARY,1,PRIVATE,0,2-Year,508800,800000066391,ART INSTITUTE OF NEW YORK CITY,1179,1179,0,309,309,0,0,0,0,0,1179,309,397,58,1488,1282
2011,31,NEW YORK,3,PROPRIETARY,1,PRIVATE,0,2-Year,508800,800000066391,ART INSTITUTE OF NEW YORK CITY,1265,1265,0,325,325,0,0,0,0,0,1265,325,356,56,1590,1373.33
2012,31,NEW YORK,3,PROPRIETARY,1,PRIVATE,0,2-Year,508800,800000066391,ART INSTITUTE OF NEW YORK CITY,1115,1115,0,328,328,0,0,0,0,0,1115,328,259,35,1443,1224.33
2013,31,NEW YORK,3,PROPRIETARY,1,PRIVATE,0,2-Year,508800,800000066391,ART INSTITUTE OF NEW YORK CITY,927,927,0,233,233,0,0,0,0,0,927,233,159,46,1160,1004.67
2010,04,CATTARAUGUS,3,PROPRIETARY,1,PRIVATE,0,2-Year,509000,800000054715,OLEAN BUS INST,87,87,0,11,11,0,0,0,0,0,87,11,25,1,98,90.67
2011,04,CATTARAUGUS,3,PROPRIETARY,1,PRIVATE,0,2-Year,509000,800000054715,OLEAN BUS INST,54,54,0,12,9,3,0,0,0,0,54,12,22,3,66,58
2012,04,CATTARAUGUS,3,PROPRIETARY,1,PRIVATE,0,2-Year,509000,800000054715,OLEAN BUS INST,48,48,0,12,12,0,0,0,0,0,48,12,15,2,60,52
2010,31,NEW YORK,3,PROPRIETARY,1,PRIVATE,1,4-Year/Grad,509100,800000065218,PACIFIC COLLEGE OF ORIENTAL MEDICINE,51,50,1,86,76,10,0,0,389,95,440,181,11,8,621,506.67
2011,31,NEW YORK,3,PROPRIETARY,1,PRIVATE,1,4-Year/Grad,509100,800000065218,PACIFIC COLLEGE OF ORIENTAL MEDICINE,85,85,0,81,74,7,0,0,402,96,487,177,9,7,664,552.4
2012,31,NEW YORK,3,PROPRIETARY,1,PRIVATE,1,4-Year/Grad,509100,800000065218,PACIFIC COLLEGE OF ORIENTAL MEDICINE,48,47,1,91,85,6,0,0,343,90,391,181,10,1,572,457.33
2013,31,NEW YORK,3,PROPRIETARY,1,PRIVATE,1,4-Year/Grad,509100,800000065218,PACIFIC COLLEGE OF ORIENTAL MEDICINE,45,43,2,106,99,7,0,0,375,82,420,188,9,6,608,488.13
2014,31,NEW YORK,3,PROPRIETARY,1,PRIVATE,1,4-Year/Grad,509100,800000065218,PACIFIC COLLEGE OF ORIENTAL MEDICINE,37,37,0,98,96,2,0,0,322,96,359,194,9,4,553,430.07
2015,31,NEW YORK,3,PROPRIETARY,1,PRIVATE,1,4-Year/Grad,509100,800000065218,PACIFIC COLLEGE OF ORIENTAL MEDICINE,45,45,0,105,100,5,0,0,336,93,381,198,7,7,579,453.2
2016,31,NEW YORK,3,PROPRIETARY,1,PRIVATE,1,4-Year/Grad,509100,800000065218,PACIFIC COLLEGE OF ORIENTAL MEDICINE,50,50,0,113,93,20,0,0,334,87,384,200,5,7,584,456.47
2017,31,NEW YORK,3,PROPRIETARY,1,PRIVATE,1,4-Year/Grad,509100,800000065218,PACIFIC COLLEGE OF ORIENTAL MEDICINE,67,67,0,94,85,9,0,0,323,86,390,180,5,5,570,455.73
2010,34,QUEENS,3,PROPRIETARY,1,PRIVATE,1,4-Year/Grad,509300,800000042227,PLAZA COLLEGE,793,772,21,0,0,0,0,0,0,0,793,0,237,0,793,793
2011,34,QUEENS,3,PROPRIETARY,1,PRIVATE,1,4-Year/Grad,509300,800000042227,PLAZA COLLEGE,751,724,27,0,0,0,0,0,0,0,751,0,249,0,751,751
2012,34,QUEENS,3,PROPRIETARY,1,PRIVATE,1,4-Year/Grad,509300,800000042227,PLAZA COLLEGE,766,747,19,0,0,0,0,0,0,0,766,0,238,0,766,766
2013,34,QUEENS,3,PROPRIETARY,1,PRIVATE,1,4-Year/Grad,509300,800000042227,PLAZA COLLEGE,726,711,15,0,0,0,0,0,0,0,726,0,233,0,726,726
2014,34,QUEENS,3,PROPRIETARY,1,PRIVATE,1,4-Year/Grad,509300,800000042227,PLAZA COLLEGE,716,699,17,0,0,0,0,0,0,0,716,0,225,0,716,716
2015,34,QUEENS,3,PROPRIETARY,1,PRIVATE,1,4-Year/Grad,509300,800000042227,PLAZA COLLEGE,732,732,0,0,0,0,0,0,0,0,732,0,234,0,732,732
2016,34,QUEENS,3,PROPRIETARY,1,PRIVATE,1,4-Year/Grad,509300,800000042227,PLAZA COLLEGE,712,712,0,0,0,0,0,0,0,0,712,0,239,0,712,712
2017,34,QUEENS,3,PROPRIETARY,1,PRIVATE,1,4-Year/Grad,509300,800000042227,PLAZA COLLEGE,811,811,0,0,0,0,0,0,0,0,811,0,331,0,811,811
2018,34,QUEENS,3,PROPRIETARY,1,PRIVATE,1,4-Year/Grad,509300,800000042227,PLAZA COLLEGE,823,823,0,0,0,0,0,0,0,0,823,0,287,0,823,823
2019,34,QUEENS,3,PROPRIETARY,1,PRIVATE,1,4-Year/Grad,509300,800000042227,PLAZA COLLEGE,858,858,0,0,0,0,0,0,0,0,858,0,265,0,858,858
2010,42,ONONDAGA,3,PROPRIETARY,1,PRIVATE,0,2-Year,509500,800000040732,BRYANT STRATTON COLLEGE - SYRACUSE,572,572,0,197,192,5,0,0,0,0,572,197,254,19,769,637.67
2011,42,ONONDAGA,3,PROPRIETARY,1,PRIVATE,0,2-Year,509500,800000040732,BRYANT STRATTON COLLEGE - SYRACUSE,585,585,0,192,189,3,0,0,0,0,585,192,180,10,777,649
2012,42,ONONDAGA,3,PROPRIETARY,1,PRIVATE,0,2-Year,509500,800000040732,BRYANT STRATTON COLLEGE - SYRACUSE,531,531,0,179,171,8,0,0,0,0,531,179,126,7,710,590.67
2013,42,ONONDAGA,3,PROPRIETARY,1,PRIVATE,0,2-Year,509500,800000040732,BRYANT STRATTON COLLEGE - SYRACUSE,391,391,0,131,129,2,0,0,0,0,391,131,95,0,522,434.67
2014,42,ONONDAGA,3,PROPRIETARY,1,PRIVATE,0,2-Year,509500,800000040732,BRYANT STRATTON COLLEGE - SYRACUSE,386,386,0,130,117,13,0,0,0,0,386,130,125,3,516,429.33
2015,42,ONONDAGA,3,PROPRIETARY,1,PRIVATE,0,2-Year,509500,800000040732,BRYANT STRATTON COLLEGE - SYRACUSE,377,377,0,112,102,10,0,0,0,0,377,112,99,0,489,414.33
2016,42,ONONDAGA,3,PROPRIETARY,1,PRIVATE,0,2-Year,509500,800000040732,BRYANT STRATTON COLLEGE - SYRACUSE,356,356,0,98,91,7,0,0,0,0,356,98,93,1,454,388.67
2017,42,ONONDAGA,3,PROPRIETARY,1,PRIVATE,0,2-Year,509500,800000040732,BRYANT STRATTON COLLEGE - SYRACUSE,359,359,0,79,78,1,0,0,0,0,359,79,89,2,438,385.33
2018,42,ONONDAGA,3,PROPRIETARY,1,PRIVATE,0,2-Year,509500,800000040732,BRYANT STRATTON COLLEGE - SYRACUSE,292,292,0,72,72,0,0,0,0,0,292,72,70,5,364,316
2019,42,ONONDAGA,3,PROPRIETARY,1,PRIVATE,0,2-Year,509500,800000040732,BRYANT STRATTON COLLEGE - SYRACUSE,304,304,0,61,60,1,0,0,0,0,304,61,85,1,365,324.33
2010,42,ONONDAGA,3,PROPRIETARY,1,PRIVATE,0,2-Year,509510,800000040923,BRYANT & STRATTON BUSINESS COLLEGE - NORTH SYRACUSE,445,445,0,179,176,3,0,0,0,0,445,179,138,8,624,504.67
2011,42,ONONDAGA,3,PROPRIETARY,1,PRIVATE,0,2-Year,509510,800000040923,BRYANT & STRATTON BUSINESS COLLEGE - NORTH SYRACUSE,365,365,0,175,171,4,0,0,0,0,365,175,100,12,540,423.33
2012,42,ONONDAGA,3,PROPRIETARY,1,PRIVATE,0,2-Year,509510,800000040923,BRYANT & STRATTON BUSINESS COLLEGE - NORTH SYRACUSE,319,319,0,163,159,4,0,0,0,0,319,163,80,5,482,373.33
2013,42,ONONDAGA,3,PROPRIETARY,1,PRIVATE,0,2-Year,509510,800000040923,BRYANT & STRATTON BUSINESS COLLEGE - NORTH SYRACUSE,295,295,0,157,149,8,0,0,0,0,295,157,47,3,452,347.33
2014,42,ONONDAGA,3,PROPRIETARY,1,PRIVATE,0,2-Year,509510,800000040923,BRYANT & STRATTON BUSINESS COLLEGE - NORTH SYRACUSE,290,290,0,154,154,0,0,0,0,0,290,154,38,0,444,341.33
2015,42,ONONDAGA,3,PROPRIETARY,1,PRIVATE,0,2-Year,509510,800000040923,BRYANT & STRATTON BUSINESS COLLEGE - NORTH SYRACUSE,285,285,0,134,134,0,0,0,0,0,285,134,29,0,419,329.67
2016,42,ONONDAGA,3,PROPRIETARY,1,PRIVATE,0,2-Year,509510,800000040923,BRYANT & STRATTON BUSINESS COLLEGE - NORTH SYRACUSE,278,278,0,129,129,0,0,0,0,0,278,129,22,0,407,321
2017,42,ONONDAGA,3,PROPRIETARY,1,PRIVATE,0,2-Year,509510,800000040923,BRYANT & STRATTON BUSINESS COLLEGE - NORTH SYRACUSE,259,259,0,115,115,0,0,0,0,0,259,115,19,1,374,297.33
2018,42,ONONDAGA,3,PROPRIETARY,1,PRIVATE,0,2-Year,509510,800000040923,BRYANT & STRATTON BUSINESS COLLEGE - NORTH SYRACUSE,82,82,0,13,13,0,0,0,0,0,82,13,30,2,95,86.33
2019,42,ONONDAGA,3,PROPRIETARY,1,PRIVATE,0,2-Year,509510,800000040923,BRYANT & STRATTON BUSINESS COLLEGE - NORTH SYRACUSE,161,161,0,75,75,0,0,0,0,0,161,75,14,3,236,186
2010,26,MONROE,3,PROPRIETARY,1,PRIVATE,0,2-Year,510000,800000050718,EVEREST INSTITUTE,1163,1163,0,166,166,0,0,0,0,0,1163,166,76,17,1329,1218.33
2011,26,MONROE,3,PROPRIETARY,1,PRIVATE,0,2-Year,510000,800000050718,EVEREST INSTITUTE,745,745,0,90,90,0,0,0,0,0,745,90,64,14,835,775
2012,26,MONROE,3,PROPRIETARY,1,PRIVATE,0,2-Year,510000,800000050718,EVEREST INSTITUTE,707,707,0,159,159,0,0,0,0,0,707,159,33,22,866,760
2013,26,MONROE,3,PROPRIETARY,1,PRIVATE,0,2-Year,510000,800000050718,EVEREST INSTITUTE,303,303,0,250,250,0,0,0,0,0,303,250,8,15,553,386.33
2014,26,MONROE,3,PROPRIETARY,1,PRIVATE,0,2-Year,510000,800000050718,EVEREST INSTITUTE,346,346,0,81,81,0,0,0,0,0,346,81,22,0,427,373
2010,34,QUEENS,3,PROPRIETARY,1,PRIVATE,0,2-Year,510300,800000066432,ST. PAUL'S SCHOOL OF NURSING - QUEENS,152,152,0,113,113,0,0,0,0,0,152,113,50,0,265,189.67
2011,34,QUEENS,3,PROPRIETARY,1,PRIVATE,0,2-Year,510300,800000066432,ST. PAUL'S SCHOOL OF NURSING - QUEENS,194,194,0,245,245,0,0,0,0,0,194,245,11,0,439,275.67
2012,34,QUEENS,3,PROPRIETARY,1,PRIVATE,0,2-Year,510300,800000066432,ST. PAUL'S SCHOOL OF NURSING - QUEENS,249,249,0,208,208,0,0,0,0,0,249,208,3,0,457,318.33
2014,34,QUEENS,3,PROPRIETARY,1,PRIVATE,0,2-Year,510300,800000066432,ST. PAUL'S SCHOOL OF NURSING - QUEENS,350,350,0,402,402,0,0,0,0,0,350,402,66,12,752,484
2015,34,QUEENS,3,PROPRIETARY,1,PRIVATE,0,2-Year,510300,800000066432,ST. PAUL'S SCHOOL OF NURSING - QUEENS,234,234,0,240,240,0,0,0,0,0,234,240,7,18,474,314
2010,35,RICHMOND,3,PROPRIETARY,1,PRIVATE,0,2-Year,510310,800000066431,ST. PAUL'S SCHOOL OF NURSING - STATEN ISLAND,154,154,0,141,141,0,0,0,0,0,154,141,117,13,295,201
2011,35,RICHMOND,3,PROPRIETARY,1,PRIVATE,0,2-Year,510310,800000066431,ST. PAUL'S SCHOOL OF NURSING - STATEN ISLAND,338,338,0,210,210,0,0,0,0,0,338,210,72,0,548,408
2012,35,RICHMOND,3,PROPRIETARY,1,PRIVATE,0,2-Year,510310,800000066431,ST. PAUL'S SCHOOL OF NURSING - STATEN ISLAND,572,572,0,146,146,0,0,0,0,0,572,146,74,0,718,620.67
2013,35,RICHMOND,3,PROPRIETARY,1,PRIVATE,0,2-Year,510310,800000066431,ST. PAUL'S SCHOOL OF NURSING - STATEN ISLAND,477,477,0,252,252,0,0,0,0,0,477,252,65,0,729,561
2014,35,RICHMOND,3,PROPRIETARY,1,PRIVATE,0,2-Year,510310,800000066431,ST. PAUL'S SCHOOL OF NURSING - STATEN ISLAND,557,557,0,155,155,0,0,0,0,0,557,155,51,0,712,608.67
2015,35,RICHMOND,3,PROPRIETARY,1,PRIVATE,0,2-Year,510310,800000066431,ST. PAUL'S SCHOOL OF NURSING - STATEN ISLAND,254,254,0,136,136,0,0,0,0,0,254,136,40,73,390,299.33
2016,35,RICHMOND,3,PROPRIETARY,1,PRIVATE,0,2-Year,510310,800000066431,ST. PAUL'S SCHOOL OF NURSING - STATEN ISLAND,214,214,0,178,178,0,0,0,0,0,214,178,0,0,392,273.33
2010,31,NEW YORK,3,PROPRIETARY,1,PRIVATE,1,4-Year/Grad,510500,800000047871,SCHOOL OF VISUAL ARTS,3394,3297,97,256,115,141,0,0,530,34,3924,290,666,94,4214,4022.93
2011,31,NEW YORK,3,PROPRIETARY,1,PRIVATE,1,4-Year/Grad,510500,800000047871,SCHOOL OF VISUAL ARTS,3418,3367,51,272,129,143,0,0,550,56,3968,328,643,11,4296,4081.07
2012,31,NEW YORK,3,PROPRIETARY,1,PRIVATE,1,4-Year/Grad,510500,800000047871,SCHOOL OF VISUAL ARTS,3389,3353,36,264,140,124,0,0,572,79,3961,343,629,3,4304,4080.6
2013,31,NEW YORK,3,PROPRIETARY,1,PRIVATE,1,4-Year/Grad,510500,800000047871,SCHOOL OF VISUAL ARTS,3349,3325,24,287,144,143,0,0,596,106,3945,393,656,2,4338,4083.07
2014,31,NEW YORK,3,PROPRIETARY,1,PRIVATE,1,4-Year/Grad,510500,800000047871,SCHOOL OF VISUAL ARTS,3450,3415,35,243,133,110,0,0,629,90,4079,333,621,2,4412,4196
2015,31,NEW YORK,3,PROPRIETARY,1,PRIVATE,1,4-Year/Grad,510500,800000047871,SCHOOL OF VISUAL ARTS,3466,3462,4,241,130,111,0,0,638,62,4104,303,696,19,4407,4209.13
2016,31,NEW YORK,3,PROPRIETARY,1,PRIVATE,1,4-Year/Grad,510500,800000047871,SCHOOL OF VISUAL ARTS,3493,3492,1,262,130,132,0,0,595,56,4088,318,742,2,4406,4197.73
2017,31,NEW YORK,3,PROPRIETARY,1,PRIVATE,1,4-Year/Grad,510500,800000047871,SCHOOL OF VISUAL ARTS,3506,3506,0,246,118,128,0,0,585,58,4091,304,698,1,4395,4196.2
2018,31,NEW YORK,3,PROPRIETARY,1,PRIVATE,1,4-Year/Grad,510500,800000047871,SCHOOL OF VISUAL ARTS,3610,3589,21,104,104,0,0,0,597,79,4207,183,882,1,4390,4273.27
2019,31,NEW YORK,3,PROPRIETARY,1,PRIVATE,1,4-Year/Grad,510500,800000047871,SCHOOL OF VISUAL ARTS,3783,3765,18,88,88,0,0,0,609,81,4392,169,962,2,4561,4453.73
2010,42,ONONDAGA,3,PROPRIETARY,1,PRIVATE,0,2-Year,510600,800000040730,SIMMONS INST OF FUNERAL SVC INC,23,23,0,9,9,0,0,0,0,0,23,9,2,2,32,26
2011,42,ONONDAGA,3,PROPRIETARY,1,PRIVATE,0,2-Year,510600,800000040730,SIMMONS INST OF FUNERAL SVC INC,23,23,0,7,7,0,0,0,0,0,23,7,7,1,30,25.33
2012,42,ONONDAGA,3,PROPRIETARY,1,PRIVATE,0,2-Year,510600,800000040730,SIMMONS INST OF FUNERAL SVC INC,36,36,0,8,8,0,0,0,0,0,36,8,8,0,44,38.67
2010,31,NEW YORK,3,PROPRIETARY,1,PRIVATE,1,4-Year/Grad,510700,800000068191,SOTHEBY'S INSTITUTE OF ART - NY,0,0,0,0,0,0,0,0,117,0,117,0,0,0,117,117
2011,31,NEW YORK,3,PROPRIETARY,1,PRIVATE,1,4-Year/Grad,510700,800000068191,SOTHEBY'S INSTITUTE OF ART - NY,0,0,0,0,0,0,0,0,129,0,129,0,0,0,129,129
2012,31,NEW YORK,3,PROPRIETARY,1,PRIVATE,1,4-Year/Grad,510700,800000068191,SOTHEBY'S INSTITUTE OF ART - NY,0,0,0,0,0,0,0,0,139,1,139,1,0,0,140,139.4
2013,31,NEW YORK,3,PROPRIETARY,1,PRIVATE,1,4-Year/Grad,510700,800000068191,SOTHEBY'S INSTITUTE OF ART - NY,0,0,0,0,0,0,0,0,134,2,134,2,0,0,136,134.8
2014,31,NEW YORK,3,PROPRIETARY,1,PRIVATE,1,4-Year/Grad,510700,800000068191,SOTHEBY'S INSTITUTE OF ART - NY,0,0,0,0,0,0,0,0,151,1,151,1,0,0,152,151.4
2015,31,NEW YORK,3,PROPRIETARY,1,PRIVATE,1,4-Year/Grad,510700,800000068191,SOTHEBY'S INSTITUTE OF ART - NY,0,0,0,0,0,0,0,0,169,3,169,3,0,0,172,170.2
2019,31,NEW YORK,3,PROPRIETARY,1,PRIVATE,1,4-Year/Grad,510700,800000068191,SOTHEBY'S INSTITUTE OF ART - NY,0,0,0,0,0,0,0,0,137,5,137,5,0,0,142,139
2010,31,NEW YORK,3,PROPRIETARY,1,PRIVATE,0,2-Year,510800,800000047342,NEW YORK CAREER INSTITUTE,475,473,2,330,269,61,0,0,0,0,475,330,63,14,805,585
2011,31,NEW YORK,3,PROPRIETARY,1,PRIVATE,0,2-Year,510800,800000047342,NEW YORK CAREER INSTITUTE,434,434,0,344,288,56,0,0,0,0,434,344,43,12,778,548.67
2012,31,NEW YORK,3,PROPRIETARY,1,PRIVATE,0,2-Year,510800,800000047342,NEW YORK CAREER INSTITUTE,423,420,3,282,217,65,0,0,0,0,423,282,29,9,705,517
2013,31,NEW YORK,3,PROPRIETARY,1,PRIVATE,0,2-Year,510800,800000047342,NEW YORK CAREER INSTITUTE,343,335,8,271,223,48,0,0,0,0,343,271,31,5,614,433.33
2014,31,NEW YORK,3,PROPRIETARY,1,PRIVATE,0,2-Year,510800,800000047342,NEW YORK CAREER INSTITUTE,276,276,0,269,246,23,0,0,0,0,276,269,20,5,545,365.67
2015,31,NEW YORK,3,PROPRIETARY,1,PRIVATE,0,2-Year,510800,800000047342,NEW YORK CAREER INSTITUTE,235,235,0,204,185,19,0,0,0,0,235,204,16,3,439,303
2016,31,NEW YORK,3,PROPRIETARY,1,PRIVATE,0,2-Year,510800,800000047342,NEW YORK CAREER INSTITUTE,207,207,0,192,153,39,0,0,0,0,207,192,30,4,399,271
2010,31,NEW YORK,3,PROPRIETARY,1,PRIVATE,1,4-Year/Grad,511200,800000065219,SWEDISH INSTITUTE INC,368,368,0,164,164,0,12,7,0,0,380,171,78,14,551,437.47
2011,31,NEW YORK,3,PROPRIETARY,1,PRIVATE,1,4-Year/Grad,511200,800000065219,SWEDISH INSTITUTE INC,293,293,0,168,168,0,0,0,0,0,293,168,79,21,461,349
2012,31,NEW YORK,3,PROPRIETARY,1,PRIVATE,1,4-Year/Grad,511200,800000065219,SWEDISH INSTITUTE INC,351,351,0,143,143,0,0,0,0,0,351,143,100,25,494,398.67
2013,31,NEW YORK,3,PROPRIETARY,1,PRIVATE,1,4-Year/Grad,511200,800000065219,SWEDISH INSTITUTE INC,501,501,0,92,90,2,0,0,0,0,501,92,36,24,593,531.67
2014,31,NEW YORK,3,PROPRIETARY,1,PRIVATE,1,4-Year/Grad,511200,800000065219,SWEDISH INSTITUTE INC,503,503,0,222,222,0,0,0,0,0,503,222,25,0,725,577
2015,31,NEW YORK,3,PROPRIETARY,1,PRIVATE,1,4-Year/Grad,511200,800000065219,SWEDISH INSTITUTE INC,521,521,0,223,223,0,0,0,0,0,521,223,30,20,744,595.33
2010,31,NEW YORK,3,PROPRIETARY,1,PRIVATE,0,2-Year,512000,800000047873,TECHNICAL CAREER INSTITUTES,4070,4070,0,419,411,8,0,0,0,0,4070,419,604,40,4489,4209.67
2011,31,NEW YORK,3,PROPRIETARY,1,PRIVATE,0,2-Year,512000,800000047873,TECHNICAL CAREER INSTITUTES,3775,3774,1,427,422,5,0,0,0,0,3775,427,1090,13,4202,3917.33
2012,31,NEW YORK,3,PROPRIETARY,1,PRIVATE,0,2-Year,512000,800000047873,TECHNICAL CAREER INSTITUTES,3152,3151,1,451,450,1,0,0,0,0,3152,451,533,5,3603,3302.33
2013,31,NEW YORK,3,PROPRIETARY,1,PRIVATE,0,2-Year,512000,800000047873,TECHNICAL CAREER INSTITUTES,2640,2640,0,381,379,2,0,0,0,0,2640,381,553,9,3021,2767
2014,31,NEW YORK,3,PROPRIETARY,1,PRIVATE,0,2-Year,512000,800000047873,TECHNICAL CAREER INSTITUTES,2385,2385,0,377,375,2,0,0,0,0,2385,377,458,8,2762,2510.67
2015,31,NEW YORK,3,PROPRIETARY,1,PRIVATE,0,2-Year,512000,800000047873,TECHNICAL CAREER INSTITUTES,1776,1776,0,305,305,0,0,0,0,0,1776,305,342,4,2081,1877.67
2016,31,NEW YORK,3,PROPRIETARY,1,PRIVATE,0,2-Year,512000,800000047873,TECHNICAL CAREER INSTITUTES,1156,1156,0,244,244,0,0,0,0,0,1156,244,154,2,1400,1237.33
2012,31,NEW YORK,3,PROPRIETARY,1,PRIVATE,0,2-Year,512300,800000076633,NEW YORK CONSERVATORY FOR DRAMATIC ARTS,273,273,0,0,0,0,0,0,0,0,273,0,91,0,273,273
2013,31,NEW YORK,3,PROPRIETARY,1,PRIVATE,0,2-Year,512300,800000076633,NEW YORK CONSERVATORY FOR DRAMATIC ARTS,273,273,0,0,0,0,0,0,0,0,273,0,91,0,273,273
2014,31,NEW YORK,3,PROPRIETARY,1,PRIVATE,0,2-Year,512300,800000076633,NEW YORK CONSERVATORY FOR DRAMATIC ARTS,237,223,14,0,0,0,0,0,0,0,237,0,56,0,237,237
2015,31,NEW YORK,3,PROPRIETARY,1,PRIVATE,0,2-Year,512300,800000076633,NEW YORK CONSERVATORY FOR DRAMATIC ARTS,286,277,9,0,0,0,0,0,0,0,286,0,103,0,286,286
2016,31,NEW YORK,3,PROPRIETARY,1,PRIVATE,0,2-Year,512300,800000076633,NEW YORK CONSERVATORY FOR DRAMATIC ARTS,268,268,0,0,0,0,0,0,0,0,268,0,76,0,268,268
2017,31,NEW YORK,3,PROPRIETARY,1,PRIVATE,0,2-Year,512300,800000076633,NEW YORK CONSERVATORY FOR DRAMATIC ARTS,237,237,0,0,0,0,0,0,0,0,237,0,80,0,237,237
2018,31,NEW YORK,3,PROPRIETARY,1,PRIVATE,0,2-Year,512300,800000076633,NEW YORK CONSERVATORY FOR DRAMATIC ARTS,257,257,0,0,0,0,0,0,0,0,257,0,107,0,257,257
2019,31,NEW YORK,3,PROPRIETARY,1,PRIVATE,0,2-Year,512300,800000076633,NEW YORK CONSERVATORY FOR DRAMATIC ARTS,313,313,0,0,0,0,0,0,0,0,313,0,112,0,313,313
2019,31,NEW YORK,3,PROPRIETARY,1,PRIVATE,1,4-Year/Grad,512400,800000091053,NEW YORK FILM ACADEMY,20,20,0,0,0,0,0,0,0,0,20,0,18,0,20,20
2010,31,NEW YORK,3,PROPRIETARY,1,PRIVATE,1,4-Year/Grad,512600,800000065220,TRI-STATE COLLEGE OF ACUPUNCTURE,0,0,0,0,0,0,0,0,134,24,134,24,0,0,158,143.6
2011,31,NEW YORK,3,PROPRIETARY,1,PRIVATE,1,4-Year/Grad,512600,800000065220,TRI-STATE COLLEGE OF ACUPUNCTURE,0,0,0,0,0,0,0,0,114,26,114,26,0,0,140,124.4
2012,31,NEW YORK,3,PROPRIETARY,1,PRIVATE,1,4-Year/Grad,512600,800000065220,TRI-STATE COLLEGE OF ACUPUNCTURE,0,0,0,0,0,0,0,0,90,18,90,18,0,0,108,97.2
2013,31,NEW YORK,3,PROPRIETARY,1,PRIVATE,1,4-Year/Grad,512600,800000065220,TRI-STATE COLLEGE OF ACUPUNCTURE,0,0,0,0,0,0,0,0,93,21,93,21,0,0,114,101.4
2014,31,NEW YORK,3,PROPRIETARY,1,PRIVATE,1,4-Year/Grad,512600,800000065220,TRI-STATE COLLEGE OF ACUPUNCTURE,0,0,0,0,0,0,0,0,96,15,96,15,0,0,111,102
2015,31,NEW YORK,3,PROPRIETARY,1,PRIVATE,1,4-Year/Grad,512600,800000065220,TRI-STATE COLLEGE OF ACUPUNCTURE,0,0,0,0,0,0,0,0,90,26,90,26,0,0,116,100.4
2017,31,NEW YORK,3,PROPRIETARY,1,PRIVATE,1,4-Year/Grad,512600,800000065220,TRI-STATE COLLEGE OF ACUPUNCTURE,0,0,0,0,0,0,0,0,94,14,94,14,0,0,108,99.6
2010,41,ONEIDA,3,PROPRIETARY,1,PRIVATE,0,2-Year,513000,800000041202,UTICA SCHOOL OF COMMERCE,356,356,0,103,23,80,0,0,0,0,356,103,83,4,459,390.33
2011,41,ONEIDA,3,PROPRIETARY,1,PRIVATE,0,2-Year,513000,800000041202,UTICA SCHOOL OF COMMERCE,267,267,0,138,63,75,0,0,0,0,267,138,53,12,405,313
2012,41,ONEIDA,3,PROPRIETARY,1,PRIVATE,0,2-Year,513000,800000041202,UTICA SCHOOL OF COMMERCE,267,267,0,88,50,38,0,0,0,0,267,88,50,23,355,296.33
2013,41,ONEIDA,3,PROPRIETARY,1,PRIVATE,0,2-Year,513000,800000041202,UTICA SCHOOL OF COMMERCE,222,222,0,102,53,49,0,0,0,0,222,102,44,5,324,256
2014,41,ONEIDA,3,PROPRIETARY,1,PRIVATE,0,2-Year,513000,800000041202,UTICA SCHOOL OF COMMERCE,117,117,0,58,58,0,0,0,0,0,117,58,38,7,175,136.33
2015,41,ONEIDA,3,PROPRIETARY,1,PRIVATE,0,2-Year,513000,800000041202,UTICA SCHOOL OF COMMERCE,97,97,0,93,52,41,0,0,0,0,97,93,18,7,190,128
2010,66,WESTCHESTER,3,PROPRIETARY,1,PRIVATE,1,4-Year/Grad,513500,800000034814,THE COLLEGE OF WESTCHESTER,994,994,0,225,182,43,0,0,0,0,994,225,255,45,1219,1069
2011,66,WESTCHESTER,3,PROPRIETARY,1,PRIVATE,1,4-Year/Grad,513500,800000034814,THE COLLEGE OF WESTCHESTER,877,877,0,220,165,55,0,0,0,0,877,220,225,3,1097,950.33
2012,66,WESTCHESTER,3,PROPRIETARY,1,PRIVATE,1,4-Year/Grad,513500,800000034814,THE COLLEGE OF WESTCHESTER,885,885,0,242,151,91,0,0,0,0,885,242,271,3,1127,965.67
2013,66,WESTCHESTER,3,PROPRIETARY,1,PRIVATE,1,4-Year/Grad,513500,800000034814,THE COLLEGE OF WESTCHESTER,948,948,0,249,135,114,0,0,0,0,948,249,232,7,1197,1031
2014,66,WESTCHESTER,3,PROPRIETARY,1,PRIVATE,1,4-Year/Grad,513500,800000034814,THE COLLEGE OF WESTCHESTER,892,892,0,233,116,117,0,0,0,0,892,233,180,8,1125,969.67
2015,66,WESTCHESTER,3,PROPRIETARY,1,PRIVATE,1,4-Year/Grad,513500,800000034814,THE COLLEGE OF WESTCHESTER,847,847,0,220,115,105,0,0,0,0,847,220,204,7,1067,920.33
2016,66,WESTCHESTER,3,PROPRIETARY,1,PRIVATE,1,4-Year/Grad,513500,800000034814,THE COLLEGE OF WESTCHESTER,808,808,0,213,119,94,0,0,0,0,808,213,186,6,1021,879
2017,66,WESTCHESTER,3,PROPRIETARY,1,PRIVATE,1,4-Year/Grad,513500,800000034814,THE COLLEGE OF WESTCHESTER,721,721,0,194,111,83,0,0,0,0,721,194,158,4,915,785.67
2018,66,WESTCHESTER,3,PROPRIETARY,1,PRIVATE,1,4-Year/Grad,513500,800000034814,THE COLLEGE OF WESTCHESTER,717,717,0,172,89,83,0,0,0,0,717,172,162,4,889,774.33
2019,66,WESTCHESTER,3,PROPRIETARY,1,PRIVATE,1,4-Year/Grad,513500,800000034814,THE COLLEGE OF WESTCHESTER,728,728,0,178,113,65,0,0,0,0,728,178,152,3,906,787.33
2010,31,NEW YORK,3,PROPRIETARY,1,PRIVATE,0,2-Year,514000,800000047902,WOOD TOBE-COBURN SCHOOL,635,635,0,0,0,0,0,0,0,0,635,0,247,0,635,635
2011,31,NEW YORK,3,PROPRIETARY,1,PRIVATE,0,2-Year,514000,800000047902,WOOD TOBE-COBURN SCHOOL,684,684,0,0,0,0,0,0,0,0,684,0,247,0,684,684
2012,31,NEW YORK,3,PROPRIETARY,1,PRIVATE,0,2-Year,514000,800000047902,WOOD TOBE-COBURN SCHOOL,567,567,0,0,0,0,0,0,0,0,567,0,177,0,567,567
2013,31,NEW YORK,3,PROPRIETARY,1,PRIVATE,0,2-Year,514000,800000047902,WOOD TOBE-COBURN SCHOOL,517,517,0,0,0,0,0,0,0,0,517,0,185,0,517,517
2014,31,NEW YORK,3,PROPRIETARY,1,PRIVATE,0,2-Year,514000,800000047902,WOOD TOBE-COBURN SCHOOL,412,412,0,0,0,0,0,0,0,0,412,0,142,0,412,412
2015,31,NEW YORK,3,PROPRIETARY,1,PRIVATE,0,2-Year,514000,800000047902,WOOD TOBE-COBURN SCHOOL,313,313,0,0,0,0,0,0,0,0,313,0,142,0,313,313
2016,31,NEW YORK,3,PROPRIETARY,1,PRIVATE,0,2-Year,514000,800000047902,WOOD TOBE-COBURN SCHOOL,306,306,0,0,0,0,0,0,0,0,306,0,121,0,306,306
